K a n a n e l o	N - K a n a n e l o
T l h o k e h o	N - T l h o k e h o
h a u f i n y a n a	h a u f i n y a n a
r o b e d i	r o b e d i
G a t e w a y	G a t e w a y
k a e	k a e
S e t s e b i	s e - t s e b i
d i l e k a n e	d i - l e k a n e
s e t s h w a n t s h o	s e - t s h w a n t s h o
a t o l o s i t s w e	a t - o l o - s - i t s - w - e
l e b i l e n g	l e b - i l - e - n g
t l o t l i l w e	t l o t l - i l - w - e
p h e t o h e l o	n - p h e t o h e l o
P h e t o h o	N - P h e t o h o
s a l l a	s a l - l - a
k g o t s o f a t s a n g	k g o t s o - f a - t s - a - n g
m e n a h a n o n g	m e - n a h a n o n g
l e l a p e n g	l e - l a p e n g
d i t h e r i s a n o n g	d i - t h e r i s a n o n g
t i i s e t s w e	t i - i s - e t s - w - e
b o t s o n a	b o - t s o n a
H l o h l o m i s o	H l o h l o m i s o
b o n t s h i t s e n g	b o n - t s h - i t s - e - n g
f o k o d i s a	f o k o d - i s - a
l e m e t s e n g	l e - m e - t s e n g
i t e l e t s e n g	i - t e l - e - t s - e - n g
M o b u n g	m o - b u n g
d i k a t s e	d i - k a t s e
p h a t l a l a d i t s w e n g	p h a t l a l a - d - i t s - w - e - n g
k g o t s o f a t s a	k g o t s o - f a - t s - a
f i h l e t s w e n g	f i h l - e - t s - w - e - n g
p o r o f e s h e n e	p o r o f e s h e n e
p h e d i s o	p h e d i s o
t l a l e h w e	t l a l e h - w - e
t s h w a s w a	t s h w a s - w - a
p a d i	p a d i
o o n a	o o n a
d i k g a n y e t s o	d i - k g a n y e t s o
t l h e k e f e t s o	n - t l h e k e f e t s o
s e h a t s e t s i	s e - h a t s e t s i
H l a h l o b o	H l a h l o b o
s e t i f i k e i t i	s e - t i f i k e i t i
t s e b o	t s e b o
t l a t s e l l e t s a n g	t l a - t s - e l - l e t s - a - n g
e f e	e f e
n a k w a n a	n - a k w a n a
h l o k a h e t s e	h l o k - a h - e t s - e
K g a o l o	N - K g a o l o
t j h e b a n o n g	n - t j h e b a n o n g
B o t e n g	b o - t e n g
b a h a t s a	b a - h a t s a
p r o j e k e	p r o j e k e
l a n a n e n o	l a n a n e n o
m a q e p h e	m a - q e p h e
i k e m i s e t s a	i k - e m - i s - e t s - a
d i n g o l w a	d i - n g o l w a
D i t j h a b a	d i - t j h a b a
s e X h o s a	s e - X h o s a
m e m o r a n d a m o	m e m o r a n d a m o
a m o h e l a n a n g	a m o h e l - a n - a - n g
B o i t e k o	b o - i t e k o
d i e j e n s i n g	d i - e j e n s i n g
i k g o t s o f a t s a	i - k g o t s o f a - t s - a
h o k a h a n n g w e	h o k - a h - a n - n g - w - e
b a k g e t h i	b a - k g e t h i
t a h i	t a h i
b a a t l e l e t e	b a - a t l e l e t e
P h u m z i l e	P h u m z i l e
n y a n e	n y a n e
D i k o l o t o	d i - k o l o t o
p o r o v i n s e	p o r o v i n s e
b o n g a k a	b o - n g a k a
b i g e y e	b i g e y e
M a k g i s t r a t a	m a - k g i s t r a t a
m o n g a t a	m o n g a t a
m a k g e t h a	m a - k g e t h a
i k a r a b e l a n g	i k - a r a b - e l - a - n g
b a b a l l a n g	b a b a l l - a - n g
D i p h e p o	d i - p h e p o
b o h a	b o h - a
b o l e b e d i	b o - l e b e d i
b a e t a p e l e	b a - e t a p e l e
u t l w a n g	u t l w - a - n g
d i i s t i t j h u s h e n e	d i - i s t i t j h u s h e n e
d i t s e b i	d i - t s e b i
p h e m a	p h e m - a
t i e h o	n - t i e h o
m o t j h a n a	m o - t j h a n a
b o t s e b i	b o - t s e b i
K o p a n e n g	K o p a n - e - n g
D a k a r	D a k a r
d i p i t s o	d i - p i t s o
f a n w e	f - a n - w - e
m o t j h a	m o - t j h a
s e p o l o t i k i	s e - p o l o t i k i
N o .	N o .
m o k e t e n g	m o - k e t e n g
t h u s i t s e	t h u s - i t s - e
d i p r o f e s h e n e n g	d i - p r o f e s h e n e n g
B o i t s e b e l o	b o - i t s e b e l o
p h e e l l o	p h e e l l o
t s a m a e l a n e n g	t s a m a - e l - a n - e - n g
t s w a l o	t s w a l o
d i f r i n g e	d i - f r i n g e
B H P	B H P
f e l a	f e l a
m o b u n g	m o - b u n g
h l o m p t j h w a	h l o m p t j h - w - a
h a k a a l o	h a k a a l o
s h e b a n a n g	s h e b - a n - a - n g
h l a p a n y a	h l a p a n y - a
t e b i s a	t e b - i s - a
S e n t j h u r i	s e - n t j h u r i
s i e l w a	s i - e l - w - a
t l a t s e l l e t s o	t l a t s e l l e t s o
T i k o l o h o n g g	T i k o l o h o n g g
e l e l l w a	e l e l l w - a
r o n g w e n g	r o n g - w - e - n g
D i p h u p h u t s o	d i - p h u p h u t s o
b o q h e k u	b o - q h e k u
s i s i n g w a n g	s i s i - n g w - a - n g
d i t j h e k e	d i - t j h e k e
d i t i f i k e i t i	d i - t i f i k e i t i
t i i s a n g	t i - i s - a - n g
t h e p e n g	t h e p e n g
u t l w i s i s e h e	u t l w - i s - i s - e h - e
m a l a l a l a o t s w e	m a - l a l a l a o t s w e
n e h e l a n a n g	n e h e l - a n - a - n g
m o r e n e n g	m o - r e n e n g
s u s u m e t s e	s u s u m - e t s - e
M o t s h w a r i	m o - t s h w a r i
s h e b a n g	s h e b - a - n g
p h e t h e l a	p h e t h - e l - a
e k a s i t a n a	e k a s i t a n a
N e d b a n k	N e d b a n k
i t h u t w a n g	i - t h u t - w - a - n g
b o i t h u t o	b o - i t h u t o
h l a h e	h l a h - e
n e h e l e t s a n o	n - e h e l e t s a n o
a r o h a n e	a r o - h - a n - e
b o i t h a p o l l o	b o - i t h a p o l l o
b a l e k a n a	b a - l e k a n a
h l o p h i s w e	h l o p h - i s - w - e
T e l	T e l
b a t s a m a i s i s a n g	b a - t s a m a i s i s a n g
p h e t o l o	n - p h e t o l o
D i p h o o f o l o	d i - p h o o f o l o
l a t e l a	l a t e l - a
m o i t h a t i	m o - i t h a t i
D e e p	D e e p
h a u l w a	h a u l - w - a
b o l e l a n g	b o l e l - a - n g
F a e l e	F a e l e
l o k i s i t s w e n g	l o k - i s - i t s - w - e - n g
M p h a l a n e	M p h a l a n e
S h e j u l e	S h e j u l e
p e h i	n - p e h i
t h a t o	n - t h a t o
d i w i l i	d i - w i l i
q o b a	q o b - a
t r a n s f e r e	t r a n s f e r - e
D i k g e t h o	d i - k g e t h o
b a v o u t i	b a - v o u t i
i t l h o k o m e l a	i - t l h o k o m e l - a
h l a k i s w a	h l a k - i s - w - a
s e b e	s e b e
t e f e l l o	n - t e f e l l o
b o 1 9 8 0	b o - 1 9 8 0
m a i k u t l o n g	m a - i k u t l o n g
M o s a d i	m o - s a d i
h a t e l a	h a t - e l - a
R e j i s t r a	R e j i s t r a
l e b e l a n g	l e b e l - a - n g
M o s e b e d i s i	m o - s e b e d i s i
d i t l o l a m o l a o	d i - t l o l a m o l a o
d i p e p h e t s o	d i - p e p h e t s o
d i k a r o h a n o	d i - k a r o h a n o
t a e l o	n - t a e l o
b o n t s h w a	b o n - t s h - w - a
h u l w e	h u l - w - e
M m e t s e	m o - M m e t s e
k w a l w a n g	k w a l - w - a - n g
t h o m o	n - t h o m o
t a o l o n g	n - t a o l o n g
t s h a b i s w a	t s h a b - i s - w - a
p r o f e s h e n e	p r o f e s h e n e
D i k e t s a h a l o	d i - k e t s a h a l o
i p o t s a	i - p o t s - a
T i k o l o h o n g	N - T i k o l o h o n g
f e l a	f e l - a
b o t s i t s o n g	b o - t s i t s o n g
d i p h e p h e t s o n g	d i - p h e p h e t s o n g
i p a k a	i - p a k - a
b a h l a n k a n a	b a - h l a n k a n a
R a p o r o t o n g	R a p o r o t o n g
L i n k	L i n k
i k g e t h e l a	i - k g e t h - e l - a
f e t e n g	f e t - e - n g
f e l e h e t s a	f e l e h e t s - a
m e h a t o	m e - h a t o
B o e l e t s i	B o - e l e t s i
t l o s w a	t l o - s - w - a
t s h w a n e l e h i l e n g	t s h w a n e l - e h - i l - e - n g
t h u p e l o	n - t h u p e l o
m m e l e	m o - m m e l e
d i t j h a n k a n e n g	d i - t j h a n k a n e n g
b a b e d i	b a b e d i
K h o u t u n g	K h o u t u n g
a s o s e e i s h e n e	a s o s e e i s h e n e
m m a l a	m o - m m a l a
s e s o s a	s e - s o s a
m o r a f e	m o - r a f e
Z i m b a b w e	Z i m b a b w e
h l o k e h e	h l o k - e h - e
t s a m a e l l a n a	t s a m a - e l - l - a n - a
p o p e h o n g	n - p o p e h o n g
S e t e r e k e n g	s e - t e r e k e n g
d i n t w a	d i - n t w a
b a h w e b i	b a - h w e b i
f u m a n w e n g	f u m a n - w - e - n g
h a t a	h a t - a
k a n t o r o	k a n t o r o
p a k a n g	p a k - a - n g
D i t i f e l o	d i - t i f e l o
b u l a	b u l - a
m a o b e n g	m a - o b e n g
n e p a h e t s e n g	n e p - a h - e t s - e - n g
d i t h e o n g	d i - t h e o n g
t o l o k a	t o l o k - a
q a l e l l a	q a l - e l - l - a
D i h l a p i	d i - h l a p i
j a r a	j a r - a
D i c h e m i c a l	d i - c h e m i c a l
C a s	C a s
f o j a r i l w e n g	f o j a r - i l - w - e - n g
m e k h u k h u n g	m e - k h u k h u n g
t h a t a f a l e t s a	t h a t a - f a l - e t s - a
n k u w a n g	n k - u w - a - n g
d i m i l i o n e n g	d i - m i l i o n e n g
t s h w a r e l o	t s h w a r e l o
t e k o l o	n - t e k o l o
t e m p u w e n g	t e m p - u w - e - n g
m i l l i o n e	m i l l i o n e
o k a	o k - a
W e s t e r n	W e s t e r n
t o k o l l o	n - t o k o l l o
t i k o l o h o n g	n - t i k o l o h o n g
t e m o s o	n - t e m o s o
n e h e l w a	n e h e l - w - a
k o n t i n e n t e n g	k o n t i n e n t e n g
k o t a r a	k o t a r a
h a t e l l a	h a t - e l - l - a
k h a m p h a n i	k h a m p h a n i
k o p t j w a	k o p t j - w - a
A d d i s	A d d i s
d i t h u t o	d i - t h u t o
K h o n s o l e i t i	K h o n s o l e i t i
m e e d i	m e - e d i
m a t i t j h e r e n g	m a - t i t j h e r e n g
n n q e n g	n - n q e n g
s e N d e b e l e	s e - N d e b e l e
f e t i l e	f e t - i l - e
e k a	e k - a
v o u t e l a	v o u t - e l - a
h l i l e n g	h l - i l - e - n g
L e r u o	l e - r u o
m a h e t l e n g	m a - h e t l e n g
P h e t o l o	N - P h e t o l o
d i t e k a n y e t s o n g	d i - t e k a n y e t s o n g
b a r u t i s i	b a - r u t i s i
b o m a s e t e r a t a	b o - m a s e t e r a t a
V M S	V M S
k g o t s o	k g o t s o
f u m a n e l a	f u m a n - e l - a
n y a h a m i s a	n y a h a m - i s - a
m a P a l e s t i n a	m a - P a l e s t i n a
q a q i l e n g	q a q - i l - e - n g
l e s h a n o	l e - s h a n o
d i k a r o l w a n a	d i - k a r o l w a n a
D a r f u r	D a r f u r
s h e b u w a n g	s h e b - u w - a - n g
e t s e n g	e t s - e - n g
f i l o s o f i	f i l o s o f i
e l e k e t e r o n e	e l e k e t e r o n e
s e k g e o	s e - k g e o
q a p a	q a p - a
s e b e d i s e t s w a	s e b e d - i s - e t s - w - a
B o l o k e h a	B o l o k - e h - a
l e b o k o s o	l e - b o k o s o
m a l o k a	m a - l o k a
b a i p e h i	b a - i p e h i
w e p o s a e t e	w e p o s a e t e
d i d i v e r s	d i - d i v e r s
K g o t s o	K g o t s o
k u t l w i s i s o	n - k u t l w i s i s o
h l o m e	h l o m - e
a l e k a n e	b a - l e k a n e
D i s e b e d i s w a	d i - s e b e d i s w a
t s h w a n e l o	t s h w a n e l o
p e n s h e n e	p e n s h e n e
k a l a n a	k a l a n a
n w a	n w - a
M e p h a t o n g	m e - p h a t o n g
t s h w a r a h a n a	t s h w a r - a h a n - a
M a o t o	m a - o t o
s e d i	l e - s e d i
d i a t e r e s e	d i - a t e r e s e
p a p a t s o	n - p a p a t s o
M e n o n t s h a	M e - n o n t s h a
b o a h i s a n i	b o - a h i s a n i
k e t e k w e	k e t e k - w - e
d i i n i s h i a l e	d i - i n i s h i a l e
m a f u m a h a d i	m a - f u m a h a d i
T h a b o	T h a b o
m e k g a t l o n g	m e - k g a t l o n g
n g o l e	n g o l - e
t s w e l e l l a n g	t s w - e l - e l - l - a - n g
l e h l o h o n o l o	l e - h l o h o n o l o
M o h a p i	M o h a p i
q o h o l l e h i l e	q o h o l l - e h - i l - e
e b a n g	e - b - a - n g
k h o m p u t a r a	k h o m p u t a r a
s w a b i s a n g	s w a b - i s - a - n g
d i k g w e b i s a n o	d i - k g w e b i s a n o
h a k a n a	h a k a n a
d i m a n e j a r a	d i - m a n e j a r a
o t l o l o h a	o t l - o l o h - a
C h i l e	C h i l e
C a n d . S c i . N a t .	C a n d . S c i . N a t .
e p a	e p - a
m a k g a b a n e	m a - k g a b a n e
b a t s a m a i s i	b a - t s a m a i s i
b o l w e t s e	b o - l w e t s e
s h e b a h a l e	s h e b - a h a l - e
t s i t s i t s e n g	t s i t s - i t s - e - n g
M a k o l o i	m a - k o l o i
t h a e t l e l e	t h a e t l e l e
b o o	b o o
k h o l e r a	k h o l e r a
S A F C E R T	S A F C E R T
p h e t h e	p h e t h - e
h o l a n g	h o l - a - n g
n t l h e n g	n - t l h e n g
L o k i s e t s a	L o k - i s - e t s - a
a r o l e l a n a n g	a r o l - e l - a n - a - n g
p h a h a m i s i t s w e n g	p h a h a m - i s - i t s - w - e - n g
a m o h e t s w e	a m o h e - t s - w - e
i t e a n y e	i - t e a - n y - e
A k a r e t s a n g	A k a r e t s - a - n g
b o p t j w a	b o p t j - w - a
p h e t o h o n g	n - p h e t o h o n g
k g i n w a	k g i n - w - a
t s e b a h a l a n g	t s e b - a h a l - a - n g
n n g w e	n n g w e
b a t l e h a n g	b a t l - e h - a - n g
L e f a	L e f - a
h a p a	h a p - a
m o h o p o l o n g	m o - h o p o l o n g
m e	m e
f u m a n e n g	f u m a n - e - n g
t s a m a e l a n g	t s a m a - e l - a - n g
d i t s w a n t l e	d i - t s w a n t l e
y u n i f o m o	y u n i f o m o
t a t e l a n o	n - t a t e l a n o
k g a o t s e	k g a o - t s - e
m e t j h i n e	m e - t j h i n e
k g e t h o l l e n g	k g e t h - o l l - e - n g
k e n e l a	k e n - e l - a
t l a m e h a n g	t l a m - e h - a - n g
t s w e l o	t s w e l o
t i n g w a	t i n g - w - a
d i n t j h a	d i - n t j h a
S t e v e	S t e v e
s e t a t e m e n t e	s e - t a t e m e n t e
b o p a	b o p - a
l e f u w e n g	l e f - u w - e - n g
t l a n n g w e	t l a n g - n - w - e
b e h u w e	b e h - u w - e
b a r e k i s i	b a - r e k i s i
r a h a	r a h - a
n e h e l a n w e	n e h e l - a n - w - e
t l a m e h i l e n g	t l a m - e h - i l - e - n g
b o l e l l a	b o l e l - l - a
t l h a b o l l o n g	n - t l h a b o l l o n g
M b e k i	M b e k i
b o m o n g	b o - m o n g
S e t s h e l o	s e - t s h e l o
n e h e l o	n - e h e l o
h l w a u w a	h l w a - u w - a
d i p a t e r o n e	d i - p a t e r o n e
s e f u b a	s e - f u b a
C e r t . S c i . N a t .	C e r t . S c i . N a t .
d i p o l a o	d i - p o l a o
d u m e l l a n g	d u m e l - l - a - n g
m o f u t s a n a	m o - f u t s a n a
t l i s w a n g	t l - i s - w - a - n g
t l h o l o	n - t l h o l o
M t h u l i	M t h u l i
d i o r i j i n a l e	d i - o r i j i n a l e
p e p a	p e p - a
t i m e l a	t i m e l - a
k e n t s w e n g	k e n - t s - w - e - n g
b o p i l e n g	b o p - i l - e - n g
d i p o d i	d i - p o d i
n t s h i w a	n t s h - i w - a
M a k h a l a t e	m a - k h a l a t e
l e b e l e t s w e	l e b e l - e - t s - w - e
i k g e t h e t s e n g	i - k g e t h - e - t s - e - n g
b o t h a t a	b o - t h a t a
t j h e s a	t j h - e s - a
n y a l a n g	n y a l - a - n g
p h e t h i s a	p h e t h - i s - a
d i e h i s i t s w e n g	d i e h - i s - i t s - w - e - n g
B i l l y	B i l l y
D i t e f e l o	d i - t e f e l o
f i h l e l l e t s w e	f i h l - e l - l - e t s - w - e
d i t h e t e f a t s i	d i - t h e t e f a t s i
b o i n j e n e r e	b o - i n j e n e r e
d i t s h u p i s i	d i - t s h u p i s i
T u r n e r	T u r n e r
h a r d	h a r d
d i p h e t o h o	d i - p h e t o h o
r u b r i k i	r u b r i k i
n e h e l e	n e h e l - e
T s h e b e d i s o	N - T s h e b e d i s o
L e n a n e o t s a m a i s o	l e - n a n e o t s a m a i s o
A k h a o n t e n g	A k h a o n t e n g
h l o k o m e l w e	h l o k o m e l - w - e
l e p e t j o	l e - p e t j o
h a e l l w a	h a e l - l - w - a
p o s w e	p o s - w - e
h a p e t s w e	h a p - e - t s - w - e
m a o t o	m a - o t o
n t j h a f a t s w a n g	n t j h a - f a - t s - w - a - n g
d i p o s i s h e n e	d i - p o s i s h e n e
i p u e l l a	i - p u - e l - l - a
f i h l e l e t s e n g	f i h l - e l - e t s - e - n g
t j h e b e l o	n - t j h e b e l o
b o f e	b o f e
t l w a e l e h a n g	t l w a e l - e h - a - n g
k g e t h w a	k g e t h - w - a
J a n n	J a n n
d i t s h i y a	d i - t s h i y a
b a s a d i n g	b a - s a d i n g
m o s w e u	m o s w e u
D i t u m e l l o	d i - t u m e l l o
M o i t h u t i	m o - i t h u t i
m o e n t o	m o - e n t o
o m m e n g	o m - m - e - n g
s e k g o m a r e t s i	s e - k g o m a r e t s i
a m m e n g	a m - m - e - n g
B o h a h l a u d i	b o - h a h l a u d i
e m e l a n g	e m - e l - a - n g
b o A f r i k a	b o - A f r i k a
N t u m e l l e	N - t u m e l - l - e
m a t l a f a d i t s w e n g	m a t l a - f a - d - i t s - w - e - n g
t l h o p h i s o	n - t l h o p h i s o
m e n a h a n o	m e - n a h a n o
E j e n s i	E j e n s i
s e b e t s a n w a	s e b e t s - a n - w - a
I s a n d l w a n a	I s a n d l w a n a
l a t e l e n g	l a t e l - e - n g
D i k o p o	d i - k o p o
b u i s a n a	b u - i s - a n - a
w i n d o w	w i n d o w
a d o p t h a	a d o p t h - a
t s h e b e d i s a n o m m o h o	n - t s h e b e d i s a n o m m o h o
d i t h o t o	d i - t h o t o
l e t l o w a	l e - t l o w a
B o i p e h i n g	b o - i p e h i n g
P e t e r	P e t e r
M a t l a f a t s o	M a - t l a f a t s o
d i p o t s o	d i - p o t s o
n t l a f a t s o n g	n - n t l a f a t s o n g
t h a k g o l a	t h a k g o l - a
d i b a p a d i	d i - b a p a d i
t l o h e l a	t l o h - e l - a
m a r e n a	m a - r e n a
t s h i r e l e t s o n g	n - t s h i r e l e t s o n g
i n e e l e n g	i - n e - e l - e - n g
o t l a	o t l - a
m a t s a t s i	m a - t s a t s i
m e r e r o n g	m e - r e r o n g
m o h l o m o n g	m o h l o m o n g
l e n a n e t a b a	l e - n a n e t a b a
P r . S c i . N a t	P r . S c i . N a t
h l a l o s w a n g	h l a l o s - w - a - n g
k g a o l o	n - k g a o l o
k g a o t s a	k g a o - t s - a
m o i t h u t i	m o - i t h u t i
t l h o d i s a n o	n - t l h o d i s a n o
b o p o l e s a	b o - p o l e s a
a p a r e t s e n g	a p a r - e - t s - e - n g
p o l a s i	p o l a s i
k e n n g w a	k e n - n g - w - a
h o k e l w e	h o k - e l - w - e
b o m a k g i s t r a t a	b o - m a k g i s t r a t a
t h a b o	t h a b o
M a p o l a s i n g	m a - p o l a s i n g
K a l u s h i	K a l u s h i
P h u p u	N - P h u p u
m o s a d i	m o - s a d i
m o t s h w a r u w a	m o - t s h w a r u w a
f e k e s e	f e k e s e
k e t e k o	n - k e t e k o
k o p a n n g w a	k o p a n - n g - w - a
S i s w a t i	S i s w a t i
d i o r e	d i - o r e
m o h l o l o h a d i	m o - h l o l o h a d i
l e f e l l w e n g	l e f - e l - l - w - e - n g
h o a	h o - a
d i l e i b o l e	d i - l e i b o l e
P o t o f o l i o	P o t o f o l i o
q e t e l l e t s e	q e t - e l - l - e t s - e
d i f o r a m o n g	d i - f o r a m o n g
b o l e l l e t s e n g	b o l e l - l - e t s - e - n g
h o l o f e t s e n g	h o l o f - e t s - e - n g
B o t j h u t j h i s i	b o - t j h u t j h i s i
a r o l a n g	a r o l - a - n g
h o o	h o o
j e	j - e
f u w a n g	f - u w - a - n g
s e t s h e n g	s e - t s h e n g
p a k w a	p a k - w - a
m e l e m o	m e - l e m o
h a b o	h a b o
f i h l e l w a n g	f i h l - e l - w - a - n g
l a e l a	l a - e l - a
l e n a n e o t s a m a i s o n g	l e - n a n e o t s a m a i s o n g
B o m a m p o d i	b o - m a m p o d i
V I C H	V I C H
s u p a	s u p a
p h o m o l o a	p h o m o l o a
t s e p a m e n g	t s e p a m - e - n g
h a h o l o h o l o	h a h o l o h o l o
t l a l e h w a	t l a l e h - w - a
f i h l i l e	f i h l - i l - e
p h a t l a l a t s w a n g	p h a t l a l a - t s - w - a - n g
p o l a n e	p o l a n e
s h e r e	s h e r e
d i p e l o n g	d i - p e l o n g
t s h w a r w a	t s h w a r - w - a
l e t j h a	l e t j h a
r a r o l l a	r a r - o l l - a
h l a l o s e h a n g	h l a l o s - e h - a - n g
f o k o l a n g	f o k o l - a - n g
s e t e f e k e i t i	s e - t e f e k e i t i
d i f o f a n e	d i - f o f a n e
s o l l a n g	s o l - l - a - n g
t s w e t s w e	t s w - e t s - w - e
p o t s o n g	n - p o t s o n g
T s h e n y o	N - T s h e n y o
t l o l o	t l o l o
m o r a r a	m o - r a r a
t s h w e r w e n g	t s h w - e r - w - e - n g
m a n a n e	m a - n a n e
b u i l e n g	b u - i l - e - n g
X u m a	X u m a
r e p o t a	r e p o t - a
a p a r t e i t i	a p a r t e i t i
i t e l a	i - t e l - a
f u p e r w e n g	f u p - e r - w - e - n g
k e n n g w e	k e n - n g - w - e
l e r a l l a	l e - r a l l a
s e b e d i s a n w e n g	s e b e d - i s - a n - w - e - n g
A b e l a n w a n g	A b - e l - a n - w - a - n g
s e d i k e n g	s e - d i k e n g
d i k r i	d i k r i
l e h a e n g	l e - h a e n g
d i k g o k a	d i - k g o k a
d i k e l e t s o	d i - k e l e t s o
p h e d i s o n g	p h e d i s o n g
E k a m p a n e	E k a m p a n e
t l a t s i t s e	t l a - t s - i t s - e
T o k o l l o	N - T o k o l l o
t h a r o l l o	n - t h a r o l l o
n k i l e n g	n k - i l - e - n g
k g a h l i s a n g	k g a h l - i s - a - n g
b o f e l o n g	b o - f e l o n g
k g o k a h a n o	n - k g o k a h a n o
P i t y a n a	P i t y a n a
s a p o t o n g	s a p o t o n g
d i t l a t l a p o	d i - t l a t l a p o
T h e m b a	T h e m b a
P o r o f a e l e	P o r o f a e l e
m o q o s u w a	m o - q o s u w a
m o t h u s i	m o - t h u s i
b o e l e t s i	b o - e l e t s i
s e t e i s h e n e n g	s e - t e i s h e n e n g
p h a h a m i s a n g	p h a h a m - i s - a - n g
p a t a	p a t - a
N q e n g	N - q e n g
k a r o l w a n a	n - k a r o l w a n a
k o n o p o	k o n o p o
M o f u t a	m o - f u t a
S o l o m o n	S o l o m o n
m a h l a k o r e	m a - h l a k o r e
t s h w e n y e h a	t s h w e n y - e h - a
h l o k w a	h l o k - w - a
t s a m a y e	t s a m a y - e
A k o f i s w a n g	A k o f - i s - w - a - n g
b o p a n g	b o p - a - n g
k h i r o	n - k h i r o
L a b o h l a n o	L a b o h l a n o
f i h l e t s w e	f i h l - e - t s - w - e
h l o p h i s w a	h l o p h - i s - w - a
d i k a t l e h o	d i - k a t l e h o
s a r u r i	s a r u r i
s a e n i l e n g	s a e n - i l - e - n g
s e f e	s e f e
b o i t h a o p o	b o - i t h a o p o
d i p h o o f o l o	d i - p h o o f o l o
l a o l w e	l a o l - w - e
k g e t l o n g	l e - k g e t l o n g
b o t s a m a i s i n g	b o - t s a m a i s i n g
D i m e l a	d i - m e l a
f e d i s w a	f e d - i s - w - a
L e p o l e s a	l e - p o l e s a
i t s h e b e d i s e t s a	i - t s h e b e d - i s - e t s - a
h l w a i l w e n g	h l w a - i l - w - e - n g
d i k a m a n o	d i - k a m a n o
e n e	e n e
T i t j h e r e	T i t j h e r e
p h a t l a l a d i t s w e	p h a t l a l a - d - i t s - w - e
l a h l e t s e	l a h l - e - t s - e
S e b o k a	s e - b o k a
a m o h e l w a n g	a m o h e l - w - a - n g
l e k g e t l o n g	l e - k g e t l o n g
D e v e l o p m e n t	D e v e l o p m e n t
t r o p i k i	t r o p i k i
d i o t o r o	d i - o t o r o
l e k o l w a	l e k o l - w - a
h l i l e	h l - i l - e
V o l .	V o l .
O S T S	O S T S
b o n t a t a e m o h o l o	b o - n t a t a e m o h o l o
l e e t s w a	l e - e t s w a
I n d i a B r a z i l A f r i k a	I n d i a B r a z i l A f r i k a
d i p h e m i t i	d i - p h e m i t i
k e n e l l e t s e n g	k e n - e l - l - e t s - e - n g
k o p a n e n g	k o p a n - e - n g
t i i s e t s w a	t i - i s - e t s - w - a
s e b a p a d i	s e - b a p a d i
s e t r o i	s e - t r o i
l e n a n e n g	l e - n a n e n g
f u m a n w a n g	f u m a n - w - a - n g
l e t h o	l e - t h o
k g o l o h a d i	k g o l o h a d i
s u t u t s a	s u t u t s - a
J a p a n	J a p a n
d i k h a s t a m a	d i - k h a s t a m a
H w a	H w a
m a b a l a	m a - b a l a
S A L G A	S A L G A
e k e t s e h i l e n g	e k e t s - e h - i l - e - n g
r e s h i o	r e s h i o
M a n y a l o	m a - n y a l o
m a b a k e n g	m a - b a k e n g
p o s w a	p o s - w - a
d i k a n t o r o	d i - k a n t o r o
l e k a n t s w e n g	l e k - a n - t s - w - e - n g
P h a e l l o	N - P h a e l l o
l e k a n e n g	l e k - a n - e - n g
h l o n n g w e n g	h l o n - n g - w - e - n g
T M 2	T M 2
d i b u i	d i - b u i
D I N T L H A T H E O	d i - N T L H A T H E O
b a t l u w a n g	b a t l - u w - a - n g
h l w a i l e n g	h l w a - i l - e - n g
h l o h l o m i s o n g	h l o h l o m i s o n g
k e n g w a	k e - n g w - a
d i C l o s e	d i - C l o s e
M o o d l e y	M o o d l e y
m p o t i l e n g	m - p o t - i l - e - n g
m e j a	m e - j a
h a t e l l e t s e	h a t - e l - l - e t s - e
S a s o l	S a s o l
d i r o m e l w a	d i - r o m e l w a
m e t j h i n i	m e - t j h i n i
b a a h i s a n e	b a - a h i s a n e
i l o	i l - o
d i s h e r e	d i - s h e r e
m o r a k g o k a h a n o	m o - r a - k g o k a h a n o
b o t s w a d i	b o - t s w a d i
l e h l a k o r e	l e - h l a k o r e
p h e t a n g	p h e t - a - n g
b a p a t s a	b a p a t s - a
h l a a h l e l l a	h l a a h l e l - l - a
k u n o	n - k u n o
b a l l a	b a l - l - a
T l w a e l e h i l e n g	T l w a e l - e h - i l - e - n g
r e k o t o	r e k o t o
t s h e h e d i t s w e	t s h e h e d - i t s - w - e
d i s e e d	d i - s e e d
t s h a b a	t s h a b - a
h a h a	h a h - a
a t e h i l e n g	a t - e h - i l - e - n g
B o t o	B o t o
B u t l e	B u t l e
d e m o k e r a s i n g	d e m o k e r a s i n g
k o n t e r a k e n g	k o n t e r a k e n g
p h e p h e t s o	p h e p h e t s o
D e m o c r a t i c	D e m o c r a t i c
A B	A B
k g o t h a l l e t s a	k g o t h a l - l - e t s - a
E n e j i	E n e j i
d i t e f e l l o	d i - t e f e l l o
l o k i s a n g	l o k - i s - a - n g
s e t o r o n g	s e - t o r o n g
m a p o l a s i n g	m a - p o l a s i n g
q a l e	q a l - e
P r e t o r i a	P r e t o r i a
b u i s a n w e	b u - i s - a n - w - e
k g a t h a l l o	n - k g a t h a l l o
E c k	E c k
k g o n a h a l a n g	k g o n - a h a l - a - n g
P o e l o	n - p o e l o
h a t e t s w e n g	h a t - e - t s - w - e - n g
s e t e m p e	s e - t e m p e
S e t s w a n t l e	s e - t s w a n t l e
s i t i s a	s i t - i s - a
L e n a n e o o	l e - n a n e o o
S o n o	S o n o
m a t l o t l o n g	m a - t l o t l o n g
t h i b e t s w e n g	t h i b - e - t s - w - e - n g
d u m e l l e t s w e n g	d u m e l - l - e t s - w - e - n g
d i b o n a s e	d i - b o n a s e
J o e	J o e
k g a l e f o	n - k g a l e f o
B a l e f i	b a - l e f i
J a n	J a n
l e f e l l w a n g	l e f - e l - l - w - a - n g
d i t u l o	d i - t u l o
k g o d i s o	n - k g o d i s o
d i p e r e	d i - p e r e
i p o n t s h a h a t s e	i - p o n - t s h - a h a - t s - e
D i k a h a r e	d i - k a h a r e
m a h a d i	m a - h a d i
a m o h e t s w e n g	a m o h e - t s - w - e - n g
l e r e o	l e - r e o
t s w e l a p e l a	t s w - e l - a -   p e l a
m m e l e n g	m m e l e n g
o k o b a t s a	o k o b a t s - a
m a m e l a	m a m e l - a
m o h w e b i	m o - h w e b i
t s w a l w a	t s w a l - w - a
d u l e t s e n g	d u l - e t s - e - n g
p e l o	p e l o
L e k g o t l a	l e - k g o t l a
t s h o s o	t s h o s o
e m a	e m - a
P A Y E	P A Y E
b e h u w e n g	b e h - u w - e - n g
p h o o f o l o	p h o o f o l o
R e k o t o	R e k o t o
b o i k g a n t s h o	b o - i k g a n t s h o
L e s h o m e	l e - s h o m e
b u e n g	b u - e - n g
b o l e l w a	b o l e l - w - a
j . k .	j . k .
l e m a t s a	l e m a t s - a
l e n y a l o n g	l e - n y a l o n g
H o o	H o o
h o d i s i t s w e n g	h o d - i s - i t s - w - e - n g
L e n y a l o	l e - n y a l o
s i t i s w e	s i t - i s - w - e
m e h a t o e	m e - h a t o e
f i l w e n g	f - i l - w - e - n g
b a o k i	b a - o k i
t s e b i s a n g	t s e b - i s - a - n g
T s h e p i s o	T s h e p i s o
d i m o r t g a g e	d i - m o r t g a g e
d i t e r a t e n g	d i - t e r a t e n g
d i s a m p o l e	d i - s a m p o l e
e m i s w a	e m - i s - w - a
h a u f i n y a n e	h a - u f i n y a n e
p a m p i t s h a n a	p a m p i t s h a n a
d i t s h w a b e l o	d i - t s h w a b e l o
d i k r a j u e i t i	d i - k r a j u e i t i
n n a n g	n n - a - n g
k o p a n y a n g	k o p a - n y - a - n g
d i i n d a s t e r i	d i - i n d a s t e r i
A p p l i c a t i o n	A p p l i c a t i o n
k u t l w e l o b o h l o k o	n - k u t l w e l o b o h l o k o
f e l e	f e l - e
k h i r i s o	n - k h i r i s o
D I R E K O T O	d i - R E K O T O
b o e l w a	b o - e l - w - a
t i t j h e r e	t i t j h e r e
d i r u b u r i k i	d i - r u b u r i k i
s e t j h e	s e - t j h e
m a t l a f a t s a n g	m a t l a - f a - t s - a - n g
f i h l e l w e	f i h l - e l - w - e
S u t h i s w a	S u t h - i s - w - a
B a t s i	B a t s i
h l a k e	h l a k - e
k a a l o	k a a l o
l a b o r a t o r i n g	l a b o r a t o r i n g
a r a b a	a r a b - a
b o h l o k o l o s i	b o - h l o k o l o s i
l e t s h o l o n g	l e - t s h o l o n g
k h a r i k h u l a m o	k h a r i k h u l a m o
h o h l e	h o h l e
b o h a t o	b o - h a t o
n a t e f e l w e	n a t e - f - e l - w - e
l a b o r a r o	l a - b o r a r o
b a t h a h a s e l l i	b a - t h a h a s e l l i
b a s e b e d i s a n i	b a - s e b e d i s a n i
m e b u s o	m e - b u s o
M O I T H U T I	m o - I T H U T I
m a t l a f a t s w a	m a t l a - f a - t s - w - a
i t s h e t l e h i l e n g	i - t s h e t l e h - i l - e - n g
i t o k i s a	i - t o k - i s - a
d i n t l h e n g	d i - n t l h e n g
m m a m o r a o	m m a m o r a o
u t l w i s i s e	u t l w - i s - i s - e
n t l a f a d i t s e	n t l a - f a - d - i t s - e
h l a h l o b e n g	h l a h l o b - e - n g
d i h l a k i s o	d i - h l a k i s o
e t e l l e t s w e	e t - e l - l - e t s - w - e
p h e p e l o	n - p h e p e l o
P a l l o	N - P a l l o
l e n g a t a	l e n g a t a
d i k g a t e l o p e l e	d i - k g a t e l o p e l e
d i P a r a l y m p i a n s	d i - P a r a l y m p i a n s
l a e b o r a r i	l a e b o r a r i
k e l o h l o k o	n - k e l o h l o k o
p h e m i t i	p h e m i t i
d i k g o m o	d i - k g o m o
e m e t s e n g	e m - e - t s - e - n g
d i p r o f e n s e	d i - p r o f e n s e
T r a n s k e i	T r a n s k e i
r u t a n g	r u t - a - n g
P e r s i a n	P e r s i a n
S e p e d i	s e - p e d i
M o f	M o f
p r o t h o k h o l e	p r o t h o k h o l e
m e t s a n a	m e - t s a n a
t i i s a	t i - i s - a
h a r e	h a - r e
d i k o m i t i	d i - k o m i t i
s i r e l e t s a	s i r - e l - e t s - a
t s h w a n e l a	t s h w a n e l - a
d i t s h w a n e l o	d i - t s h w a n e l o
f a n w a	f - a n - w - a
d i r e k o t o	d i - r e k o t o
h o k e l w a	h o k - e l - w - a
h l o o h o	h l o o h o
t h e h i l w e	t h e h - i l - w - e
b u u w a	b u - u w - a
t s w e t s e p e l e	t s w - e t s - e -   p e l e
m e r a f o n g	m e - r a f o n g
d i h l a p i	d i - h l a p i
t i a	t i - a
i k o p a n y a	i - k o p - a n y - a
n n e	n n - e
b a h l a k i s i	b a - h l a k i s i
d i b o p e h o n g	d i - b o p e h o n g
d i k g a r u r u	d i - k g a r u r u
b u s e t s w a	b u s - e t s - w - a
L a o l w e n g	L a o l - w - e - n g
S A N T A C O	S A N T A C O
b e n g d i k a b o	b e - n g d i k a b o
b o n a h a l e t s a	b o n - a h a l - e t s - a
b a r u t i	b a - r u t i
R e n t e	R e n t e
k a e k a e	k a e k a e
b a a b i	b a - a b i
s i r e l e t s e h a	s i r - e l - e t s - e h - a
a m a n a	a m - a n - a
A t o l o s i t s w e n g	A t - o l o - s - i t s - w - e - n g
d i t e b o h i s o	d i - t e b o h i s o
s e h l o p h e n g	s e - h l o p h e n g
h l a k i l e	h l a k - i l - e
d i t l a m o	d i - t l a m o
m o s e b e d i s i	m o - s e b e d i s i
d i k i l o m e t a r a	d i - k i l o m e t a r a
D i k g o k a	d i - k g o k a
p h e t h a h a t s w a	p h e t h - a h a - t s - w - a
b o y o n a	b o - y o n a
h o h l e h o h l e	h o h l e h o h l e
J o h n	J o h n
p e o n g	p e o n g
M e b u s o	m e - b u s o
K h a m p e p e	K h a m p e p e
d t i	d t i
l e m o	l e m o
t s a m a i s o n g	t s a m a i s o n g
l o k i s w a n g	l o k - i s - w - a - n g
B o d u l a s e t u l o	b o - d u l a s e t u l o
s i r e l e t s e h i l e	s i r - e l - e t s - e h - i l - e
m a r a l l a	m a - r a l l a
A B E T	A B E T
t u n a	t u n a
n t s h e t s o p l e	n t s h e t s o p l e
E k s e k e t i f i	E k s e k e t i f i
n y e t s w e	n y - e t s - w - e
h l a h e l l a n g	h l a h - e l - l - a - n g
s e s o l e	s e - s o l e
r a p o r o t o	r a p o r o t o
D i k g w e d i n g	d i - k g w e d i n g
a h w a	a h - w - a
b a t l e	b a t l - e
s e b e d i s e n g	s e b e d - i s - e - n g
m a f a t s h e n g	m a - f a t s h e n g
t e k a n o	n - t e k a n o
d i k g e t h o	d i - k g e t h o
M a n a n e	m a - n a n e
h l o h l e l l e t s a	h l o h l - e l - l - e t s - a
k a l a f i	n - k a l a f i
t s h o h a n y e t s o	t s h o h a n y e t s o
m o k o t l a n a	m o - k o t l a n a
a b e l w a	a b - e l - w - a
k g o t h a l a	k g o t h a l - a
G D P	G D P
P h e r e k g o n g	N - P h e r e k g o n g
h l a k u b e l e	b o - h l a k u b e l e
i k g a t h a t s a	i - k g a t h a - t s - a
m a t h a t e n g	m a - t h a t e n g
b a r e k i	b a - r e k i
t s h i t i s o	n - t s h i t i s o
e m a i l	e m a i l
s e t l a n k a n e n g	s e - t l a n k a n e n g
D i p r i m i r i	d i - p r i m i r i
d i p h o s o	d i - p h o s o
b o h a h l a o d i	b o - h a h l a o d i
m a s e t e r a t a	m a s e t e r a t a
n e h u w e	n e h - u w - e
s e k e	s e k e
t l o s w e	t l o - s - w - e
b o l a y a	b o l a y - a
l e s h w e	l e s h - w - e
m a q h e k u	m a - q h e k u
b o t a l a n a	b o - t a l a n a
M e m o r a n d a m o	M e m o r a n d a m o
a h a n g	a h - a - n g
n t s h e d i t s e	n t s h - e d - i t s - e
J I P S A	J I P S A
b o t j h o t j h i s i	b o - t j h o t j h i s i
n e h e l a n o	n - e h e l a n o
q o b e l l w a	q o b e l - l - w - a
h u l e l w a	h u l - e l - w - a
t e m o n g	n - t e m o n g
h l a k o r e n g	d i - h l a k o r e n g
b a o k a m e d i	b a - o k a m e d i
f o u n u	f o u n u
T e k a n y e t s o	N - T e k a n y e t s o
P o r o f e n s i	P o r o f e n s i
b a l e k g o t l a	b a - l e k g o t l a
k o p i l w e	k o p - i l - w - e
D i t s w a n t l e	d i - t s w a n t l e
i k a r a b e l a	i k - a r a b - e l - a
d i b e n e f i t i	d i - b e n e f i t i
b o i k t i l a e t s o n g	b o - i k t i l a e t s o n g
t l o t l a	t l o t l - a
b a k i l w e	b a k - i l - w - e
r e k w a n g	r e k - w - a - n g
b a e t a p a l e	b a - e t a p a l e
s o r o	s o r o
l o b o l a	l o b o l a
b a k o p i	b a - k o p i
k e n y e	k e - n y - e
m e d i s e	m e d - i s - e
e t s a h e t s e n g	e t s - a h - e t s - e - n g
l e i b o l e n g	l e - i b o l e n g
m a t h w a s o n g	m a - t h w a s o n g
n a t e f e l w a n g	n a t e - f - e l - w - a - n g
b a d i t j h a b a	b a - d i t j h a b a
r a p o l a s i	r a p o l a s i
k o p a n e t s w e n g	k o p a n - e - t s - w - e - n g
d i t o k i s e t s o	d i - t o k i s e t s o
h o k a h a n e n g	h o k - a h - a n - e - n g
i p h u m a n a	i - p h u m a n - a
m a h e t l a	m a - h e t l a
m m i n i	m o - m m i n i
h l e k e f e t s a n g	h l e k e f e t s - a - n g
d i a k h a o n t e n t e	d i - a k h a o n t e n t e
b o l o k o l o h o	b o - l o k o l o h o
b a r w e t s a n a	b a - r w e t s a n a
i p u s a n g	i - p u s - a - n g
b a t l i l e n g	b a t l - i l - e - n g
a k h a o n t e	a k h a o n t e
B o e m o	b o - e m o
k g u t s u f a t s a n g	k g u t s u f a - t s - a - n g
a k a r e t s a	a k a r e t s - a
f e l a n g	f e l - a - n g
k u n o n g	n - k u n o n g
b o l e t s e n g	b o l e - t s - e - n g
t l i l i k a	t l i l i k - a
n t j h a f e t s e n g	n t j h a - f - e t s - e - n g
s e h l o o h o n g	s e - h l o o h o n g
L a b u s c h a g n e	L a b u s c h a g n e
S e b e t s w a n g	S e b e t s - w - a - n g
a k a n y a	a k - a n y - a
b o i p i l e t s o	b o - i p i l e t s o
d u m e l l e	d u m e l - l - e
C D W s	C D W s
b a n e n g	b a - n e n g
l e s h o m e	l e - s h o m e
s a e n n w e	s a e n - n - w - e
T h u t a p u o	N - T h u t a p u o
k g e t h u w e	k g e t h - u w - e
f o r e s h e	f o r e s h e
m a t e l e l e	m a t e l e l e
M a r i s e f e	M a - r i s e f e
k e n y e l l e t s o	k e n y e l l e t s o
F e k s e	F e k s e
a l a	a l - a
b o r o m i w a	b o - r o m i w a
d u l e t s w e	d u l - e t s - w - e
n y o l o h i l e	n y o l o h - i l - e
I B S A	I B S A
i t h u t e n g	i - t h u t - e - n g
b o n k g o n o	b o - n k g o n o
b a b a l l e	b a b a l l - e
k g e t l o	l e - k g e t l o
l o k e l w a n g	l o k - e l - w - a - n g
s e t e r a e k e	s e - t e r a e k e
n a k o n y a n a	n - a k o n y a n a
m o n k o	m o - n k o
n t l h e n e	n - t l h e n e
e t s u w a	e t s - u w - a
C h a d	C h a d
f u p a r e	f u p a r - e
d i r e t u r n	d i - r e t u r n
h o t l e	h o t l e
f e t w a	f e t - w - a
m o l a o t h e o	m o - l a o t h e o
y a n g	y - a - n g
d i n k u	d i - n k u
k g e t h o l l a	k g e t h - o l l - a
w e l a n g	w - e l - a - n g
p o s e t s e	p o s - e t s - e
b a l w a n t s h a n a	b a - l w a n t s h a n a
f u m a n e h a	f u m a n - e h - a
d i t e r e n e	d i - t e r e n e
f e h l w a	f e h l - w - a
l e b a t o w e n g	l e - b a t o w e n g
d i s e k e j u l e	d i - s e k e j u l e
n g a t a n y a n a	n g a t a n y a n a
N a i c k e r	N a i c k e r
U I F	U I F
l e d i b o h o	l e - d i b o h o
k h o p h i	k h o p h i
d i h l a b e l o	d i - h l a b e l o
d i p e o	d i - p e o
a r a b e l e	a r a b - e l - e
d i t s a m a i s o	d i - t s a m a i s o
m o h l a k i s i	m o - h l a k i s i
t s h w a r a h a n e	t s h w a r - a h a n - e
k g a b a n e	k g a b a n e
t j h a n k a n e	t j h a n k a n e
l w a n t s h i t s e	l w - a n - t s h - i t s - e
d i b o n t o	d i - b o n t o
b o i k i t l a e t s o n g	b o - i k i t l a e t s o n g
A f r i k a n s e	A f r i k a n s e
l e r i s e f e	l e - r i s e f e
I D	I D
m o k g a t l o n g	m o - k g a t l o n g
b o r a s a e n s e	b o - r a s a e n s e
m e k g w a t s h e b e t s o	m e - k g w a t s h e b e t s o
f u t h u m a t s w a	f u t h u - m a - t s - w - a
l a b a l a b e l w a n g	l a b a l a b - e l - w - a - n g
m m u s o i	m m u s o i
M a A f r i k a	m a - A f r i k a
i p a p i s i t s w e	i - p a p - i s - i t s - w - e
r a r o l o h a	r a r - o l o h - a
t s e j w a	t s e j - w - a
e l e l l i s i t s w e	e l - e l - l - i s - i t s - w - e
h l o o h o n g	h l o o h o n g
E b i l e	E - b - i l - e
b o i t e k o	b o - i t e k o
N e n g w e k h u l u	N e n g w e k h u l u
b o l e t s w e n g	b o l e - t s - w - e - n g
A b a t t o i r	A b a t t o i r
k a t l e h o n g	n - k a t l e h o n g
d u m e l l a n w e	d u m e l - l - a n - w - e
t l h o d i s a n o n g	n - t l h o d i s a n o n g
m m e d i	m m e d i
M a r u o	m a - r u o
r e n t e	r e n t e
i k u t l w a	i k - u t l - w - a
L u t h u t l i	L u t h u t l i
l e f u w e	l e f - u w - e
d i P o l i c e	d i - P o l i c e
Z A R	Z A R
I R P 5	I R P 5
h a t i s i t s w e n g	h a t - i s - i t s - w - e - n g
t s h e n y o	n - t s h e n y o
f o k a	f o k - a
a r o l w a n g	a r o l - w - a - n g
B a t h o b a t s h o	b a - t h o b a t s h o
A l e x a n d r a	A l e x a n d r a
l a b o r a t o r i	l a b o r a t o r i
j e w a	j e - w - a
b o t h o t o	b o - t h o t o
k g e t h i l w e n g	k g e t h - i l - w - e - n g
h l o d i s a n a	h l o d - i s - a n - a
a r o h a n a	a r o - h - a n - a
N k u w a	N k - u w - a
m e l a w a n e n g	m e - l a w a n e n g
k g o l o n g	n - k g o l o n g
p h e e l l e t s e	p h e - e l - l - e t s - e
R e a d e r	R e a d e r
m i d d l e	m i d d l e
D i t s e b i	d i - t s e b i
b a t s i	b a t s i
k h a m p e i n i	k h a m p e i n i
a t o l o s w e	a t - o l o - s - w - e
h o p o l e t s w e	h o p o l - e - t s - w - e
d i k a b e l o	d i - k a b e l o
l e b e l l e t s e n g	l e b e l - l - e t s - e - n g
S I T E	S I T E
P r . S c i . N a t .	P r . S c i . N a t .
l o k a n g	l o k - a - n g
d i h l o p h e n g	d i - h l o p h e n g
T j h o n a	t j h o n - a
d i q e t o	d i - q e t o
l e k o l e	l e k o l - e
d i a n t i r e t r o v i r a l	d i - a n t i r e t r o v i r a l
M o o f i s i r i	m o - o f i s i r i
k h o p i	k h o p i
i k g o p o t s e	i - k g o p o - t s - e
A s i a	A s i a
d i p o n a h a l o	d i - p o n a h a l o
t s h e b e d i s a n o n g	n - t s h e b e d i s a n o n g
b o p h a h a m o	b o - p h a h a m o
t l h a b o l l o	n - t l h a b o l l o
t e b e l o	n - t e b e l o
h l o k a n g	h l o k - a - n g
N E D L A C	N E D L A C
k a b o	n - k a b o
L o k e l w a n g	L o k - e l - w - a - n g
M o p h a t o	m o - p h a t o
t s h e p a h a l e	t s h e p - a h a l - e
m o l w a n e l a	m o - l w a n e l a
f e	f e
k g o l w e h a n g	k g o l w - e h - a - n g
v o u t a	v o u t - a
h i r i l w e n g	h i r - i l - w - e - n g
a b e l a n e	a b - e l - a n - e
D i k e p e	d i - k e p e
n y a t s a n g	n y a t s - a - n g
a m o h e l w a	a m o h e l - w - a
d i b o k a	d i - b o k a
h l o m m e	h l o m - m - e
F e t o h a	F e t - o h - a
T l w a e l e h a n g	T l w a e l - e h - a - n g
r u p e l l e	r u p - e l - l - e
b o t e l o	b o - t e l o
f e t o t s w e n g	f e t o - t s - w - e - n g
t i i s o	t i i s o
q e t i l e n g	q e t - i l - e - n g
b o l o k o l o h i	b o - l o k o l o h i
e k e t s e h i l e	e k e t s - e h - i l - e
m a m a t i	m a - m a t i
l e b i s w a	l e b - i s - w - a
b o a h i s a n e	b o - a h i s a n e
d u m e l a n g	d u m e l - a - n g
M o l a e t s a	m o - l a e t s a
R i c k	R i c k
m a I s r a e l	m a - I s r a e l
t h e l e b e s h e n e	t h e l e b e s h e n e
s u s u m e l l e t s a	s u s u m - e l - l - e t s - a
a r o l e l a n w a n g	a r o l - e l - a n - w - a - n g
T I S A	T I S A
t l h a l o s o	n - t l h a l o s o
l e n y a l o	l e - n y a l o
i p h u m a n a n g	i - p h u m a n - a - n g
l e k a l e k a n e	l e k a l e k - a n - e
h l o l w a	h l o l - w - a
N h l a n h l a	N h l a n h l a
k a h o n g b o t j h a	n - k a h o n g b o t j h a
p a t i s a n e n g	p a t i s - a n - e - n g
d i t e k e s i	d i - t e k e s i
d i t s h a e n o	d i - t s h a e n o
a t e r e s e	a t e r e s e
m o h i r u w a	m o - h i r u w a
k e l o	n - k e l o
d i t e b e l l o	d i - t e b e l l o
s e k e t s w a n a	s e - k e t s w a n a
d i t j h a b e n g	d i - t j h a b e n g
i t s h e t l e h i l e	i - t s h e t l e h - i l - e
R e p o t a	R e p o t - a
n y a l a n e	n y a l - a n - e
f i h e l l w a	f i h - e l - l - w - a
l a o l a n g	l a o l - a - n g
l e q h w a	l e - q h w a
t s e b i s a h a l e n g	t s e b - i s - a h a l - e - n g
b a t h u s i	b a - t h u s i
m a e l a n a	m a - e l a n a
k i l e n g	k - i l - e - n g
f i h l e l l e l a	f i h l - e l l - e l - a
G C P	G C P
G M	G M
M a h l a n g u	M a h l a n g u
b o i t e l o	b o - i t e l o
R w a n d a	R w a n d a
S A M D I	S A M D I
f e k s e	f e k s e
e k e t s e h a	e k e t s - e h - a
d e i r i	d e i r i
d i t a n k a	d i - t a n k a
m a i t e k o n g	m a - i t e k o n g
k g o t h a t s w a	k g o t h a - t s - w - a
s e t l e	s e t l e
r e r i s a n a	r e r - i s - a n - a
L E L E K E L A	L E L E K - E L - A
d i t o i l e t r y	d i - t o i l e t r y
k g e t h w a n g	k g e t h - w - a - n g
m o y e n g	m o - y e n g
f i h l e l w a	f i h l - e l - w - a
k a h l o l o	n - k a h l o l o
d i k h o p h i	d i - k h o p h i
R F M O s	R F M O s
C o m o r o s	C o m o r o s
b u w a n g	b u - w - a - n g
m e r i a n a	m e - r i a n a
d i n o n y a n a	d i - n o n y a n a
W e p o s a e t e	W e p o s a e t e
f i h l e l l e t s w e n g	f i h l - e l - l - e t s - w - e - n g
l o k i s e t s a	l o k - i s - e t s - a
h l o k o l o s i	h l o k o l o s i
s i t i s a n a	s i t - i s - a n - a
f i l w e	f - i l - w - e
S e t o r o	s e - t o r o
n t j h a f a t s w e	n t j h a - f a - t s - w - e
d i w e p o s a e t e n g	d i - w e p o s a e t e n g
l e b e l l w a	l e b e l - l - w - a
d i a l f a b e t e	d i - a l f a b e t e
t s h i y a	n - t s h i y a
d i k i m i	d i - k i m i
b e h e l a	b e h - e l - a
E b a	E - b - a
s a p o t o	s a p o t o
l e b o h i s a	l e b o h - i s - a
t s h o h l a	t s h o h l - a
k e n y e l e t s w a	k e - n y - e l - e t s - w - a
n u c l e r e	n u c l e r e
F E T	F E T
E A C	E A C
D I R A P O R O T O	d i - R A P O R O T O
m o t l o t l o	m o - t l o t l o
l e t s e t s w a	l e t s - e t s - w - a
n e p a h a l o	n e p a h a l o
t s h w a r a h a n e n g	t s h w a r - a h a n - e - n g
S E L E L E K E L A	S E - L E L E K E L A
e l w a	e l - w - a
d i b a s a r i	d i - b a s a r i
t l o l a	t l o l - a
p r o f e s h i n a l e	p r o f e s h i n a l e
s u t h i s w a	s u t h - i s - w - a
s e b e d i s a n a n g	s e b e d - i s - a n - a - n g
t a b a t a b a	t a b a t a b a
L a b o h l a n o	L a - b o h l a n o
M i d d l e	M i d d l e
b a k u d i	b a - k u d i
r e r a n g	r e r - a - n g
m p o t s a	m - p o t s - a
b o s e m o r a f e	b o - s e m o r a f e
d i q o s o	d i - q o s o
t h i b e l w a	t h i b - e l - w - a
k o p a n y e	k o p a - n y - e
a b i l w e n g	a b - i l - w - e - n g
M a m e l a	M a m e l - a
t s a m a i s a	t s a m a - i s - a
b a a h l o d i	b a - a h l o d i
t e l l a	t e l - l - a
b o h e	b o h - e
p a l o n g	n - p a l o n g
d i t l a m o n g	d i - t l a m o n g
n e h w a	n e h - w - a
s u s u m e t s w a	s u s u m - e t s - w - a
i t e a n g w a n g	i - t e a - n g - w - a - n g
m o e m e d i	m o - e m e d i
l e b e l l w a n g	l e b e l - l - w - a - n g
m a n o l l a	m a n o l l - a
k e n t s w e	k e n - t s - w - e
b o n e	b o - n e
R e p h a b o l i k i	R e p h a b o l i k i
d i p h a t l a l a t s i n g	d i - p h a t l a l a t s i n g
m o l e m o n g	m o - l e m o n g
t s h i y a	t s h i y a
m a k o k o	m a - k o k o
m e t s w a k o	m e - t s w a k o
m a t s a t s i n g	m a - t s a t s i n g
p o t l a k a n g	p o t l a k - a - n g
T s e p a m i s o	T s e p a m i s o
T s h e b e d i s a n o n g	N - T s h e b e d i s a n o n g
s i r i l e	s i r - i l - e
b o l e t s e	b o l e - t s - e
l a t e l a n a n g	l a t e l - a n - a - n g
D i p e h e l o	d i - p e h e l o
p h e t h e l w a	p h e t h - e l - w - a
N o r t h	N o r t h
i t h e t s a	i - t h e t s - a
h o k a h a n n g w a	h o k - a h - a n - n g w - a
m i l i y o n e	m i l i y o n e
C h i n a A f r i k a	C h i n a A f r i k a
n y a l a	n y a l - a
t l h a l o h a n y o	n - t l h a l o h a n y o
m e t s o	m e - t s o
d i p h a h l o	d i - p h a h l o
s e s h e n e	s e - s h e n e
h i r i s a n g	h i r - i s - a - n g
l e k o t s w e	l e k o - t s - w - e
d i m i n e r a l e	d i - m i n e r a l e
d i t e k o	d i - t e k o
p h i h l e l o n g	n - p h i h l e l o n g
f a t s h e	f a - t s h e
b a k i l w e n g	b a k - i l - w - e - n g
b u s e t s a	b u s - e t s - a
t s w e l e	t s w - e l - e
m o h l a	m o - h l a
k e t s a h a l o	n - k e t s a h a l o
L e w a t l e	l e - w a t l e
M l a m b o N g c u k a	M l a m b o N g c u k a
s e w a	s e - w a
K o p o n g	N - K o p o n g
t e k a n y o	n - t e k a n y o
m o t s o	m o - t s o
s i r e l e t s w e	s i r - e l - e t s - w - e
p o t l a k i s i t s e n g	p o t l a k - i s - i t s - e - n g
n a l e d i	n - a l e d i
h a u f i n y a n e	h a u f i n y a n e
b a l l w a	b a l - l - w - a
S A C U	S A C U
b i t s w a	b i t s - w - a
I T	I T
h a t e l l w a	h a t - e l - l - w - a
m a k g e t l o k g e t l o	m a - k g e t l o k g e t l o
d i F o c a l	d i - F o c a l
h o k a h a n e	h o k - a h - a n - e
f e d i s w e	f e d - i s - w - e
s e f a n e	s e - f a n e
b o m p o d i	b o - m p o d i
t s h w a u w a	t s h w a - u w - a
t s o t e l l e	t s o t - e l - l - e
w w w . g o v . z a	w w w . g o v . z a
m o s o	m o - s o
m a r i h a	m a - r i h a
B e i j i n g	B e i j i n g
b a a h e l a n i	b a - a h e l a n i
n g o t s w e	n g o - t s - w - e
t s h w a r w a n g	t s h w a r - w - a - n g
m m a r a k e n g	m o - m m a r a k e n g
t l h a s e l o	n - t l h a s e l o
b o n a h a l a n g	b o n - a h a l - a - n g
P h a t l a l t s o	P h a t l a l t s o
r a l a n g	r a l - a - n g
m e d u m o	m e - d u m o
y o	y - o
s e a b o	s e - a b o
s i l w a n g	s i l - w - a - n g
m o l a o n g	m o - l a o n g
f e p e l a	f e p - e l - a
m a e t o	m a - e t o
b o t e m e n g a t e n g	b o - t e m e n g a t e n g
t s h w a s a	t s h w a s - a
S e t s i	s e - t s i
k o p a n t s e n g	k o p a - n - t s - e - n g
l e b a h a n e	l e b - a h - a n - e
d i k g w e b o n g	d i - k g w e b o n g
d i A p o s t i l l e	d i - A p o s t i l l e
l o k e t s w e n g	l o k - e - t s - w - e - n g
b o l a	b o l - a
d i p h o k o t s o	d i - p h o k o t s o
O l i m p i k i	O l i m p i k i
R u t e h a	R u t - e h - a
t s h e h e t s w a	t s h e h e t s - w - a
p a m p i r i	p a m p i r i
m a t l a f a t s o	m a - t l a f a t s o
t l h a k i s o n g	n - t l h a k i s o n g
h a s a n e	h a s - a n - e
t s h w a r e l w a	t s h w a r - e l - w - a
d i p h a t l a l a t s i	d i - p h a t l a l a t s i
t l h a p i	t l h a p i
n a t s w e	n a t s - w - e
h l o m m e n g	h l o m - m - e - n g
B e r g	B e r g
k g a t h a l e t s e h e	k g a t h a l - e - t s - e h - e
D i p r o f e n s e	d i - p r o f e n s e
k g a s e	k g a s e
S e p h e t h o n g	s e - p h e t h o n g
a m o h e t s e n g	a m o h e - t s - e - n g
d i k a r a t a	d i - k a r a t a
h o p o l e	h o p o l - e
e k e t s e	e k e t s - e
s h e b a n e	s h e b - a n - e
h a o l o	h a o l o
k e n y e l l e t s w e	k e - n y - e l - l - e t s - w - e
a b a l o n e	a b a l o n e
d i p e e l e t s o	d i - p e e l e t s o
k g w e b o n g	n - k g w e b o n g
f e t i s a	f e t - i s - a
L e t h a t h a m a	l e - t h a t h a m a
b o t j h a b e n g	b o - t j h a b e n g
f e t i s i t s w e n g	f e t - i s - i t s - w - e - n g
B o t s a	B o t s - a
b o h o l o h o l o	b o - h o l o h o l o
L e r i s e f e	L e - r i s e f e
M P C C s	M P C C s
p h e t h i s w a	p h e t h - i s - w - a
H o d i l e n g	H o d - i l - e - n g
k a m a h a n y o	n - k a m a h a n y o
h o l o	h o l o
J 2 4 3	J 2 4 3
E E Z	E E Z
k g u t s h w a n e	k g u t s h w a n e
m a t h a n g	m a t h - a - n g
h l o p h i s i t s w e n g	h l o p h - i s - i t s - w - e - n g
l e h a t o n g	l e - h a t o n g
q e a q e o	q e a q e o
b o k g o p o	b o - k g o p o
r e k a n g	r e k - a - n g
I C D	I C D
b o r i s e f e	b o - r i s e f e
d i p h e p e t s o	d i - p h e p e t s o
k o l o t a n g	k o l o t - a - n g
d i k e t s a h a l o	d i - k e t s a h a l o
k g w e d i n g	k g w e d i n g
l e k g o t l e n g	l e - k g o t l e n g
d i n t l h a t h e o	d i - n t l h a t h e o
s i t i s w a	s i t - i s - w - a
i n e h e l a	i - n e h e l - a
T l h a g w a n a	T l h a g w a n a
p o t a	p o t - a
n t s h e d i t s e p e l e	n t s h - e d - i t s - e - p e l e
m a t s a p a	m a - t s a p a
d a t a	d a t a
f o k o l a	f o k o l - a
h a n y e n y a n e	h a n y e n y a n e
h l a o l a	h l a o l - a
p h a h a m i s e n g	p h a h a m - i s - e - n g
k g w e d i	k g w e d i
s w a b i l e	s w a b - i l - e
M o l a t o	m o - l a t o
m p h o	n - m p h o
d i k a r a b e l o	d i - k a r a b e l o
p h o k o t s e h o	n - p h o k o t s e h o
j j	j j
b o l o k e	b o l o k - e
a p a r a	a p a r - a
t h e k o	n - t h e k o
m e n g a t a n y a n a	m e n g a t a n y a n a
s e t s i	s e - t s i
h l o m a	h l o m - a
b e l a e l w a	b e l a e l - w - a
b o n n q o s a	b o - n n q o s a
m e n y e n y a n e	m e n y e n y a n e
d i t h o n a m e n t e	d i - t h o n a m e n t e
i t s h w a r a	i - t s h w a r - a
d i p h u p h u t s o	d i - p h u p h u t s o
k e n y e l l e t s e	k e - n y - e l - l - e t s - e
s u s u m e l e t s a	s u s u m - e l - e t s - a
o n	o n
S A B S	S A B S
h l o l e n g	h l o l - e - n g
h l o p h i s i t s e n g	h l o p h - i s - i t s - e - n g
s e t s w a n t l e	s e - t s w a n t l e
d i p r o f e n s e n g	d i - p r o f e n s e n g
t l a l e h o p o e l e t s o	t l a l e h o p o e l e t s o
d i b e k e	d i - b e k e
K h a n s e l e	K h a n s e l e
D e a t	D e a t
m e b e d i	m e b e d i
I t l h o p h i s a	I - t l h o p h - i s - a
D i k e l e t s o	d i - k e l e t s o
d i p e h e l o n g	d i - p e h e l o n g
k g o t h a l e t s a n g	k g o t h a l - e - t s - a - n g
M e l a o	m e - l a o
T a l a	T a l a
S i t i s e	S i t - i s - e
S o w e t o	S o w e t o
D i h l o p h a	d i - h l o p h a
m e h l a p e	m e - h l a p e
t r a s t i	t r a s t i
d u m e l l a n e n g	d u m e l - l - a n - e - n g
t j e n a	t j e n a
d i p o l o t i k i n g	d i - p o l o t i k i n g
d i k g o t h a l e t s o n g	d i - k g o t h a l e t s o n g
t s e b i s o	t s e b i s o
n y o r e l w a	n y o r - e l - w - a
b o n t s h a n g	b o n - t s h - a - n g
m e t l e	m e t l e
h o n o	h o n o
d u l e	d u l - e
f i h l e l l e t s e	f i h l - e l - l - e t s - e
m o s e b e s t i	m o s e b e s t i
k a r a b e l o	n - k a r a b e l o
n y a l w a	n y a l - w - a
m a i t s h w a r o	m a - i t s h w a r o
k g a f e t s a	k g a f e t s - a
h l a k o l w e	h l a k o l - w - e
n t l a f a d i t s w e	n t l a - f a - d - i t s - w - e
t e n y e t s e h a	t e n y e t s - e h - a
n y o l o h e t s e n g	n y o l o h - e t s - e - n g
S e t s o	s e - t s o
d i l a e s e n s e	d i - l a e s e n s e
f i h l e l e t s w e n g	f i h l - e l - e t s - w - e - n g
M m a s e t e r a t a	M m a s e t e r a t a
r u t e h a	r u t - e h - a
m m a l w a n a	m o - m m a l w a n a
d i p a k e n g	d i - p a k e n g
t l a l e h e l a	t l a l e h - e l - a
I S B N	I S B N
k o t s i	k o t s i
M p u l a n g a	M p u l a n g a
D i k a m a n o	d i - k a m a n o
d i n y e w e	d i - n y e w e
h a h a h o l o	h a h a h o l o
n y o n y e h a n g	n y o n y - e h - a - n g
D i n y e w e	D i - n y e w e
k a d i m a	k a d i m - a
t s h u s u m e t s o	n - t s h u s u m e t s o
I n t e r n e t	I n t e r n e t
s u p i s a n g	s u p - i s - a - n g
d i v i s a	d i - v i s a
P u i s a n o	N - P u i s a n o
C e n t r e s	C e n t r e s
k o l w a n e	k o l w a n e
m o k e t e	m o - k e t e
p h e d i s a n o	p h e d i s a n o
t l i s e	t l - i s - e
D i p o l e l w a n a	d i - p o l e l w a n a
i n k e l a	i - n k - e l - a
t s o s o l o s o	t s o s o l o s o
b o l o	b o l o
l e t o t o	l e - t o t o
f e t o l w e	f e t o l - w - e
m a q e p h e n g	m a - q e p h e n g
m a n y a l o	m a - n y a l o
A b a b a	A b a b a
l e f i s w a	l e f - i s - w - a
k g e t h u w e n g	k g e t h - u w - e - n g
t h u s e n g	t h u s - e - n g
S e s o l e	s e - s o l e
K H A R I K H U L A M O	K H A R I K H U L A M O
n g o d i s a	n g o - d i s - a
N t l h a t h e o	N - t l h a t h e o
d i A r t i c l e s	d i - A r t i c l e s
t l h o k o m e d i s o	n - t l h o k o m e d i s o
F o m e t e	F o m e t e
s e Z u l u	s e - Z u l u
y o h l e	y o h l e
P h e t h e l e	P h e t h - e l - e
b e h i l w e n g	b e h - i l - w - e - n g
T e k e n o l o j i	T e k e n o l o j i
m a n a n e o n g	m a - n a n e o n g
m a l e b a n a	m a - l e b a n a
E x p l o r e r	E x p l o r e r
p a t s i	p a t s i
k g o d i s e h i l e	k g o d i s - e h - i l - e
B o s h o d u	b o - s h o d u
b a b a l l a	b a b a l l - a
b o 1 9 9 0	b o - 1 9 9 0
t j h e t j h e l l a	t j h e t j h - e l - l a
L e h a	L e h a
h l a l o s i t s w e	h l a l o s - i t s - w - e
a p a r t e i t e	a p a r t e i t e
P h a p a n y e t s a n o	N - P h a p a n y e t s a n o
d i t u m e l l o	d i - t u m e l l o
d i t h e k o	d i - t h e k o
b o t l e n g	b o - t l e n g
d u m e t s e	d u m e - t s - e
M a b p i	M a b p i
t s e p a m i s i t s e	t s e p a m - i s - i t s - e
t s h w a n a	t s h w a n - a
f u p u t s a	f u p u t s - a
d i t l h a h l o b o n g	d i - t l h a h l o b o n g
s e l e h a e	s e - l e h a e
A s g i S A	A s g i S A
d i p h a e l l o	d i - p h a e l l o
t s i l a t s i l a	t s i l a t s i l - a
D i b u i	d i - b u i
d i k a h l o l o	d i - k a h l o l o
b a k a	b a k - a
n g a t a n a	l e - n g a t a n a
t i i s w e	t i - i s - w - e
M a w a	m a - w a
P h e t h a h a t s o	P h e t h a h a t s o
h w e b i s a n a	h w e b - i s - a n - a
f o k o t s w a	f o k o t s - w - a
T s e b i s o	T s e b i s o
H l o o h o	H l o o h o
d i t h o l l o	d i - t h o l l o
a m a h a n y a	a m - a h a - n y - a
m a t s h w e l e	m a - t s h w e l e
d i h l o p h a	d i - h l o p h a
B u l a	B u l - a
q a d i l e	q a d - i l - e
m i l i o n e	m i l i o n e
q e t e l l o	q e t e l l o
B i k o	B i k o
p a p a d i	n - p a p a d i
t o k i s e t s o	n - t o k i s e t s o
M a k e n o	m a - k e n o
l e l e k i s a	l e l e k - i s - a
t e m a n e n g	n - t e m a n e n g
p a t e h i l e n g	p a t - e h - i l - e - n g
s i s i n t s w e n g	s i s i n - t s - w - e - n g
b a h l a b a n i	b a - h l a b a n i
f o k o d i t s w e	f o k o d - i t s - w - e
t s h w a n e n g	t s h w a n - e - n g
l e f i s a	l e f - i s - a
M A F I S A	m a - F I S A
S e h l o p h e n g	s e - h l o p h e n g
s e k o l o t o n g	s e - k o l o t o n g
t s w a l w a n g	t s w a l - w - a - n g
T l i s a	T l - i s - a
b o b o n a	b o - b o n a
e m e l a	e m - e l - a
l e s h w a n g	l e s h - w - a - n g
e j e n s i	e j e n s i
s a e n a n g	s a e n - a - n g
r u w a	r u - w - a
k e n t s e n g	k e n - t s - e - n g
u t l w i s i s i t s e	u t l w - i s - i s - i t s - e
p h u m u l w e	p h u m u l - w - e
d i a p a r o	d i - a p a r o
b a b a l l w e	b a b a l l - w - e
e n t a	e n t - a
n t l a f a d i t s w e n g	n t l a - f a - d - i t s - w - e - n g
B a l e m i r u i	b a - l e m i r u i
t s a m a i s a n a n g	t s a m a - i s - a n - a - n g
B o l o	B o l o
d u m e l a	d u m e l - a
d i t s h i y e n g	d i - t s h i y e n g
l e b e l o n g	l e - b e l o n g
t s e b i s w a n g	t s e b - i s - w - a - n g
K u n o	N - K u n o
p o l a s i n g	p o l a s i n g
b o k e l l w a	b o k - e l - l - w - a
b o d u m e d i	b o - d u m e d i
k e n w e	k e n - w - e
i t a o l a	i - t a o l - a
D i t l a m o n g	d i - t l a m o n g
b e e l e d i t s e	b e - e l - e - d i t s - e
s e t j h w a	s e t j h - w - a
B o t e m e n g a t e n g	b o - t e m e n g a t e n g
t s e b i l e	t s e b - i l - e
L e h o d i m o n g	l e - h o d i m o n g
k g o n a n g	k g o n - a - n g
d i k o t a r a	d i - k o t a r a
b o q a p i	b o - q a p i
p e p e s a	p e p e s - a
m o t h a t i n g	m o - t h a t i n g
N E D B A N K	N E D B A N K
l e k e h a	l e k - e h - a
n y a l e	n y a l - e
k e t e l o	n - k e t e l o
b o l o k e h a	b o l o k - e h - a
b a t l i l e	b a t l - i l - e
l a y o u t	l a y o u t
B P O	B P O
l e h l a k o r e n g	l e - h l a k o r e n g
s a p o k o n t i n e n t e	s a p o k o n t i n e n t e
b a a h i s a n i	b a - a h i s a n i
f e t o h a	f e t - o h - a
l e n g w a	l e n g - w - a
b o r a k g w e b o	b o - r a k g w e b o
s e a h e l o	s e - a h e l o
h l o t s w e n g	h l o - t s - w - e - n g
s e t h e o	s e - t h e o
b u u w a n g	b u - u w - a - n g
d i t s h i t a	d i - t s h i t a
m a k g o t l a	m a - k g o t l a
s e t o p o	s e - t o p o
h i r u w e	h i r - u w - e
M a t s a t s i n g	m a - t s a t s i n g
n g o d i s i t s w e n g	n g o - d i s - i t s - w - e - n g
t j h e s e h o n g	n - t j h e s e h o n g
S e a f o r i k a	s e - a f o r i k a
p h e h e l l e t s w e	p h e h - e l - l - e t s - w - e
P h e p e t s o	P h e p e t s o
S o m a l i a	S o m a l i a
t s e b a n g	t s e b - a - n g
h a b a n y a n g	h a b a n y - a - n g
T s h w a s a	T s h w a s - a
p h e t h e t s w e	p h e t h - e t s - w - e
N y e n y a n e	N y e n y a n e
M a n a n e o n g	m a - n a n e o n g
h l w a	h l w - a
h e	h e
d i p h u m a n o	d i - p h u m a n o
p e o l a n o	n - p e o l a n o
p h a d i m e h o	n - p h a d i m e h o
s i y a	s i y - a
p h e t h e h i l e	p h e t h - e h - i l - e
r u t e n g	r u t - e - n g
b o l o t s a n a	b o - l o t s a n a
r a r o l l w a n g	r a r - o l l - w - a - n g
m e t r i k i	m e - t r i k i
k u l a n g	k u l - a - n g
f e t e l e t s e n g	f e t - e l - e t s - e - n g
t s a m a e l l a n e	t s a m a - e l - l - a n - e
b a l l w a n g	b a l - l - w - a - n g
k o b o	k o b o
b o n t s h w a n g	b o n - t s h - w - a - n g
h l e k e f e t s w a n g	h l e k e f e t s - w - a - n g
d i p h u m a n t s h o	d i - p h u m a n t s h o
r o m e l w e	r o m - e l - w - e
E u r o p e	E u r o p e
P h e p e l o	N - P h e p e l o
k o t s i n g	k o t s i n g
r a l a	r a l - a
f u p e r e	f u p - e r - e
s e b o p e h o n g	s e - b o p e h o n g
a r o h a n e n g	a r o - h - a n - e - n g
D i t l h a p i	d i - t l h a p i
m o l e m i r u i	m o - l e m i r u i
h l a k a n g	h l a k - a - n g
L w e t s e	L w e t s e
b o f a l l i	b o - f a l l i
k g i t l a	k g i t l - a
t s i t l a l l e l a	t s i t l a - l l - e l - a
n y e n y a n e	n y e n y a n e
D i t l a l e h o	d i - t l a l e h o
s e b e d i s i t s w e n g	s e b e d - i s - i t s - w - e - n g
b o w e n a	b o - w e n a
i t h u t w a	i - t h u t - w - a
b o k e l l e t s w e n g	b o k - e l - l - e t s - w - e - n g
t s h e p a	t s h e p - a
p i t s o	n - p i t s o
k g o n e h a	k g o n - e h - a
b o r a b e	b o - r a b e
r e k o t w a	r e k o t - w - a
s i r e l e d i t s e n g	s i r - e l - e d - i t s - e - n g
d i k h o l e t j h e	d i - k h o l e t j h e
s e t u l o	s e - t u l o
m e n o	m e n o
a p a r e	a p a r - e
L e k g o t l e n g	l e - k g o t l e n g
S a l o o j e e	S a l o o j e e
k o l o t w a n g	k o l o t - w - a - n g
d i l a b o r a t o r i	d i - l a b o r a t o r i
k o p e	k o p - e
m a b a k e t e	m a - b a k e t e
D i p h e m i t i	d i - p h e m i t i
t s h e p i s o	t s h e p i s o
e n t e	e n t e
A m e r i k a	A m e r i k a
m a h l a k o r e n g	m a - h l a k o r e n g
t e m p u w a	t e m p - u w - a
s a e n s e n g	s a e n s e n g
h l e k e f e t s w a	h l e k e f e t s - w - a
P a p a t s o	N - P a p a t s o
n t h o	n - t h o
b o k e l e t s a	b o k - e l - e t s - a
p e o	p e o
s i t i s a n g	s i t - i s - a - n g
p e p e n e n e n g	p e p e n e n e n g
k g o l w a	k g o l - w - a
D i n t l h a t h e o	d i - n t l h a t h e o
q o b a n e	q o b - a n - e
S e t e f i k e i t i	s e - t e f i k e i t i
p u s o	n - p u s o
t s h w a r e t s w e	t s h w a r - e - t s - w - e
m a q h u b u n g	m a - q h u b u n g
p r o f e s h e n a l e	p r o f e s h e n a l e
k g o b o k a n t s w e n g	k g o b o k a - n - t s - w - e - n g
m o k g w a t s h e b e t s o	m o - k g w a t s h e b e t s o
m e l a w a n a	m e - l a w a n a
P o r o f i l e	P o r o f i l e
w e l a	w - e l - a
B i r o	B i r o
l e e m e	l e - e m e
l e w a t l e	l e - w a t l e
k a b e l a n o	n - k a b e l a n o
t e a	t e - a
E t s u w a	E t s - u w - a
l e f s h w a n g	l e f s h - w - a - n g
m a f o l o f o l o	m a - f o l o f o l o
D i m i n e r a l e	d i - m i n e r a l e
s o	s o
h o d i l e n g	h o d - i l - e - n g
m e t s a n e n g	m e - t s a n e n g
D i a b o	d i - a b o
b o l e k o d i	b o - l e k o d i
q a q i l e	q a q - i l - e
r e k o t a	r e k o t - a
k i l e	k - i l - e
p h e t s e n g	p h e - t s - e - n g
K g a u	K g a u
b o i p u s o	b o - i p u s o
m o h a l e	m o - h a l e
d i m e t a l e	d i - m e t a l e
p a t e r o l a	p a t e r o l - a
b a k w e t l i s i	b a - k w e t l i s i
B o t e g n i k i	b o - t e g n i k i
p h e s e n t e	p h e s e n t e
d i r u t e h i	d i - r u t e h i
f a e l e	f a e l e
t l w a e l o	t l w a e l o
b o i p h i h l e l l o	b o - i p h i h l e l l o
d i t e r a t a	d i - t e r a t a
p h e t h e t s w e n g	p h e t h - e t s - w - e - n g
d i p l o m a	d i - p l o m a
C o t e	C o t e
b e u w e	b e - u w - e
h o k e h a n g	h o k - e h - a - n g
p r o f e n s e	p r o f e n s e
h e t l e	h e t l - e
B o t h a t a	B o - t h a t a
K o t l o	N - K o t l o
S e l e l e k e l a	s e - l e l e k e l a
m o t s e	m o - t s e
b o h l a n o	b o - h l a n o
h o d i m o h a d i	h o d i m o h a d i
d i c o d i c i l	d i - c o d i c i l
r a f u w a	r a f - u w - a
M o r e k i	m o - r e k i
m o k o l o t i	m o - k o l o t i
b e t e t s h a n a	b e t e - t s h - a n - a
p h e t o h o	n - p h e t o h o
n g w a n a b o	m o - n g w a n a b o
h l a h e t s e	h l a h - e - t s - e
r e k i s w a	r e k - i s - w - a
m a n y a l o n g	m a - n y a l o n g
K h o m i s h e n e	K h o m i s h e n e
T l a l a	T l a l a
e m i s w e	e m - i s - w - e
p h e e l l a	p h e - e l - l - a
b e e l e d i t s w e n g	b e - e l - e - d i t s - w - e - n g
f o l a k g a	f o l a k g a
d i t e f i s o	d i - t e f i s o
n e p o	n - e p o
i l w e n g	i l - w - e - n g
m a p o n e s a	m a - p o n e s a
m a k a t s w a n g	m a k a - t s - w - a - n g
k a t i s o	n - k a t i s o
b o t s a	b o t s - a
e t e l l e	e t - e l - l - e
o k e l a n g	o k - e l - a - n g
D i k g o k a h a n o	d i - k g o k a h a n o
d i p o l o k e l o	d i - p o l o k e l o
h a n g	h a n g
l o k i s i t s w e	l o k - i s - i t s - w - e
f e l l a	f e l - l - a
b o l e l e	b o l e l - e
t s o n a t s o n a	t s o n a t s o n a
b e i l w e n g	b e - i l - w - e - n g
B a k o p i	b a - k o p i
o m i s i t s w e n g	o m - i s - i t s - w - e - n g
m o h l o k o m e d i	m o - h l o k o m e d i
n g o d i s a n g	n g o - d i s - a - n g
a b a	a b - a
s e t e	s e - t e
d i i z i m b i z o	d i - i z i m b i z o
D i b i l i	d i - b i l i
k a b o n g	n - k a b o n g
r o m e l l a n g	r o m - e l - l - a - n g
s i r e l e d i t s w e	s i r - e l - e d - i t s - w - e
t h a h a s e l l o	t h a h a s e l l o
m o d i t j h a b a	m o - d i t j h a b a
B o e m o n g	b o - e m o n g
k g e l l w e	k g e l - l - w - e
r a r a h a n a	r a r a h - a n - a
p h e t e l o	p h e t e l o
d i p h i h l e l l o	d i - p h i h l e l l o
b a h o l w a n e	b a - h o l w a n e
h l w e l l a	h l w - e l - l - a
L R A D	L R A D
d i p o e l o	d i - p o e l o
D i f o r o m o	d i - f o r o m o
N t l h e n g	N - t l h e n g
T j h a t a	N - T j h a t a
p e r s e n t e	p e r s e n t e
b a l e f i	b a - l e f i
Z o u n u	Z o u n u
m a s o l e	m a - s o l e
T j h e b o k a k a r e t s o	N - T j h e b o k a k a r e t s o
D i t i k o l o h o	d i - t i k o l o h o
T e s e l l o	N - T e s e l l o
s e t u l o n g	s e - t u l o n g
M a b o p o	m a - b o p o
h l o k e h e n g	h l o k - e h - e - n g
m o A f r i k a	m o - A f r i k a
d u m e l l w a n g	d u m e l - l - w - a - n g
h l o m a m i s a	h l o m a m - i s - a
n a h a n a	n a h a n - a
k u l a	k u l - a
b o n a m o	b o - n a m o
d i n t l h a k g o l o	d i - n t l h a k g o l o
s e h l o o h o	s e - h l o o h o
k g u t s u f a t s w a n g	k g u t s u f a - t s - w - a - n g
e t s e t s a	e t s - e t s - a
q o j w a	q o j - w - a
I n a	I n a
m o t h e o n g	m o - t h e o n g
H l a p i	H l a p i
B r i a n	B r i a n
q e t e l a	q e t - e l - a
A T M	A T M
l e b i s a n g	l e b - i s - a - n g
l e k a n n g w a n g	l e k - a n - n g w - a - n g
S u d a n	S u d a n
f i h l e	f i h l - e
r o m m e n g	r o m - m - e - n g
s a m p o l e	s a m p o l e
d i t o k i s o	d i - t o k i s o
b a t h e i	b a - t h e i
f e l l e t s e n g	f e l - l - e t s - e - n g
s e b e t s a n e	s e b e t s - a n - e
b a k w a n g	b a k - w - a - n g
s e h o l l a	s e - h o l l a
s u p a n g	s u p - a - n g
k g o t s o f a d i t s e	k g o t s o - f a - d - i t s - e
t h u s a n g	t h u s - a - n g
M a w a t l e	m a - w a t l e
t s h e h e t s a n g	t s h e h e t s - a - n g
t l a t s e	t l a - t s - e
n k u w e n g	n k - u w - e - n g
m e h l a	m e - h l a
t e m o k e r a s i	t e m o k e r a s i
p o s e t s w a	p o s - e t s - w - a
d i t a e l e	d i - t a e l e
d i o d i t i	d i - o d i t i
d i t l e t l e b o	d i - t l e t l e b o
K g w e b i s a n o	N - K g w e b i s a n o
n e t e f a d i t s w e n g	n e t e - f a - d - i t s - w - e - n g
b a i t h a o p i	b a - i t h a o p i
t s h w a r o	t s h w a r o
I s s e l	I s s e l
d i p s y c h o l o g i s t	d i - p s y c h o l o g i s t
t s h i s i n y o	n - t s h i s i n y o
d i r a p o t o	d i - r a p o t o
k e n e l l a n a n g	k e n - e l - l - a n - a - n g
s e b a k e n g	s e - b a k e n g
h l a h i s w a n g	h l a h - i s - w - a - n g
k a n o	n - k a n o
b e i t i	b e i t i
p a t l i s i s o	n - p a t l i s i s o
s e t o r o	s e - t o r o
I n d a b a	I n d a b a
f o j a r a	f o j a r - a
m e h o l o	m e h o l o
l a t e l w a n g	l a t e l - w - a - n g
r e r e t s w e n g	r e r - e - t s - w - e - n g
R o b e r t	R o b e r t
d i s o s a e t h i	d i - s o s a e t h i
p a k i	p a k i
d i t a t e m e n t e	d i - t a t e m e n t e
s h e j w a	s h e j - w - a
r o m e l a n g	r o m - e l - a - n g
s e n t j h u r i	s e - n t j h u r i
s e f a t e	s e - f a t e
q a p o d i s a	q a p o d i s - a
t s h u p a m o l a t o	n - t s h u p a m o l a t o
t r a n s f e r w a n g	t r a n s f e r - w - a - n g
m a q h a m a	m a - q h a m a
l o h l e	l o h l e
b o d i p l o m a t i k i	b o - d i p l o m a t i k i
i p e h e t s e n g	i - p e h - e - t s - e - n g
p h a h a m a	p h a h a m - a
d i b a j e t e	d i - b a j e t e
t s h w a n e l a n g	t s h w a n e l - a - n g
f e t i s e t s a n g	f e t - i s - e t s - a - n g
r u t e h i l e n g	r u t - e h - i l - e - n g
N c u m i s a	N c u m i s a
n e t e f a t s a n g	n e t e - f a - t s - a - n g
f a l l a	f a l l - a
c u r s o r	c u r s o r
C o n g o	C o n g o
s e k e p e n g	s e - k e p e n g
f e r e h l a	f e r e h l - a
R i p h a b o l i k i	R i p h a b o l i k i
n w e h a n g	n w - e h - a - n g
l e b i s i t s w e	l e b - i s - i t s - w - e
d i s a v i n g s	d i - s a v i n g s
n o s e t s o	n - n o s e t s o
f e l l w a	f e l - l - w - a
d i t j h a n k a n a	d i - t j h a n k a n a
b i n a n g	b i n - a - n g
p h e n y e k o l l a	p h e n y e k o l l - a
s e b u i	s e - b u i
B a k h o m i s h e n a r a	b a - k h o m i s h e n a r a
r e k i s e	r e k - i s - e
S E S O T H O	S E - S O T H O
r o m e t s w e n g	r o m - e - t s - w - e - n g
h l o k a h a l e	h l o k - a h a l - e
t h e o l e l o	t h e o l e l o
p h u p u t s o n g	n - p h u p u t s o n g
l a p e n g	l e - l a p e n g
L e l o k o	l e - l o k o
m o f o k o l o	m o - f o k o l o
l e k a n e	l e k - a n - e
f o k o t s e h a	f o k o t s - e h - a
b o k g a b a n e n g	b o - k g a b a n e n g
7 3 %	7 3 %
D i k h o p i	d i - k h o p i
t s a m a i s w e	t s a m a - i s - w - e
n y o l o h a	n y o l o h - a
t a t a i s a n g	t a t a - i s - a - n g
D i b e k e n g	d i - b e k e n g
n t l h a k e m o	n - n t l h a k e m o
B u i s a n a	B u - i s - a n - a
q h w a d i l e n g	q h w a d - i l - e - n g
B o t s e b i	b o - t s e b i
t s e p a m i s i t s w e n g	t s e p a m - i s - i t s - w - e - n g
d i p e r s e n t e n g	d i - p e r s e n t e n g
s e b e l e	s e - b e l e
D i p r o j e k e	d i - p r o j e k e
m a o k a	m a - o k a
h l a h l o j w a n g	h l a h l o j - w - a - n g
t e f i s o	n - t e f i s o
b a i t h u t i m m o h o	b a - i t h u t i m m o h o
q o s w a n g	q o s - w - a - n g
e s i t a	e s i t a
h o b e	h o b e
j a r e l a n a	j a r - e l - a n - a
i p h e p h e t s o	i p h e p h e t s o
t o b i l e n g	t o b - i l - e - n g
d i k h o u t u	d i - k h o u t u
n y a l a n a n g	n y a l - a n - a - n g
d i t h e t h e f a t s i	d i - t h e t h e f a t s i
l e h l o y o	l e - h l o y o
b o n t s h e	b o n - t s h - e
B o p o l e s a	b o - p o l e s a
D i p a m p i r i	d i - p a m p i r i
h a e l l a	h a e l - l - a
K g a n y a	K g a n y a
m a d i m a b e	m a - d i m a b e
d i w e p o s a e t e	d i - w e p o s a e t e
S e t i f i k e i t	s e - t i f i k e i t
D i n t w a	d i - n t w a
m o n g o l o	m o - n g o l o
d i t e m a	d i - t e m a
b o t e n g	b o - t e n g
t s h w a e l a	t s h w a - e l - a
e t s u w a n g	e t s - u w - a - n g
D i k h o u t u	d i - k h o u t u
t l w a e l e h i l e n g	t l w a e l - e h - i l - e - n g
m e y a	m e y a
d i t e m e n g	d i - t e m e n g
h l o k o m e t s e	h l o k o m e - t s - e
n g a n g i s a n a	n g a n g - i s - a n - a
p a n e l e n g	p a n e l e n g
I R P 6	I R P 6
m o b u	m o - b u
t s w a l a n a n g	t s w a l - a n - a - n g
m a d u l o n g	m a - d u l o n g
M o e n t o	m o - e n t o
P r o j e k e	P r o j e k e
p e h e l o	n - p e h e l o
f e t e	f e t - e
h a b i l e n g	h a b - i l - e - n g
d i t e f e l o	d i - t e f e l o
m o l a t o	m o - l a t o
B a m m a l a	b a - m m a l a
h l o t s e	h l o - t s - e
r o n g w a	r o n g - w - a
k o	k o
s u t h i s a	s u t h - i s - a
b a h l o d i	b a - h l o d i
b a l a n g	b a l - a - n g
n k i l w e n g	n k - i l - w - e - n g
n e h e l a	n e h e l - a
l e k a	l e k - a
m o t l e t l e b i	m o - t l e t l e b i
T h u p e l o	N - T h u p e l o
m a h l a t s i p a a	m a - h l a t s i p a a
M e h a t o	m e - h a t o
h l o p h i s e d i t s w e n g	h l o p h - i s - e d - i t s - w - e - n g
r a r a h a n e n g	r a r a h - a n - e - n g
a t e r e s e n g	a t e r e s e n g
m a f u	m a - f u
i t o k i s e t s a	i - t o k - i s - e t s - a
a t o l o s e t s a	a t - o l o - s - e t s - a
H l a k u b e l e	b o - h l a k u b e l e
I n t a s t e r i	I n t a s t e r i
K w a D u k u z a	K w a D u k u z a
k a k e n g	k a k - e - n g
k e n e l e t s e n g	k e n - e l - e - t s - e - n g
O n k g o p o t s e	O n k g o p o t s e
b o i p i l e t s o n g	b o - i p i l e t s o n g
T s h o k o l l o	N - T s h o k o l l o
T h u s o n g	T h u s o n g
d i y u n i t i	d i - y u n i t i
t l a t s w e	t l a - t s - w - e
e t s u w e	e t s - u w - e
l a b a l a b e l a n g	l a b a l a b - e l - a - n g
K a b o	N - K a b o
t s e i b i s o n g	t s e i b i s o n g
s i r e l e t s e h e	s i r - e l - e t s - e h - e
p o s e	p o s - e
l a b a l a b e l a	l a b a l a b - e l - a
m e h a r o	m e - h a r o
h u l w a n g	h u l - w - a - n g
K e n n g w a	K e n - n g - w - a
S a p o s i d i	S a p o s i d i
t l e l e r e k e	t l e l e r e k e
s e d u m e d i	s e - d u m e d i
T s h e b e d i s d a n o	T s h e b e d i s d a n o
n y o l o h e l a	n y o l o h - e l - a
M o t s h e a n o n g	m o - t s h e a n o n g
P h a p o s i	P h a p o s i
t e m a	n - t e m a
d i t s h e b e d i s a n o	d i - t s h e b e d i s a n o
h l a l o s i t s e n g	h l a l o s - i t s - e - n g
p e l e n y a n a	p e l e n y a n a
m a q w e t h a	m a - q w e t h a
S E H L O O H O	s e - H L O O H O
b a t h e h i	b a - t h e h i
d i i n s t i t j h u s h e n e n g	d i - i n s t i t j h u s h e n e n g
d i t s h e b e t s o	d i - t s h e b e t s o
t s h a b o	t s h a b o
t s w a k a n a	t s w a k - a n - a
M P S	M P S
p h e t h a h e t s e n g	p h e t h - a h - e t s - e - n g
L o b o l a	L o b o l a
l e f s h w e	l e f s h - w - e
S t r i n i	S t r i n i
L a t i n	L a t i n
q e t e l l w a	q e t - e l - l - w - a
m a	m a
t s h w e r e	t s h w - e r - e
b a h l o k o m e d i	b a - h l o k o m e d i
e n j i n e	e n j i n e
N t l h a	N - t l h a
L e n a n e n g	l e - n a n e n g
m e a h o	m e - a h o
d i t e f o	d i - t e f o
f i h l i s e	f i h l - i s - e
n t j h a f a d i t s w e n g	n t j h a - f a - d - i t s - w - e - n g
f e n y a	f e n y - a
n a l a n e	n a l a n e
T j h e	T j h e
J 1 5 5	J 1 5 5
p r o f e s h e n e n g	p r o f e s h e n e n g
k g o l o h a d i	n - k g o l o h a d i
k a m a n o n g	n - k a m a n o n g
a m a n e	a m - a n - e
I N M A R S A T	I N M A R S A T
l k e t s e n g	I k - e t s - e - n g
s a e n w a n g	s a e n - w - a - n g
l e f i s w e	l e f - i s - w - e
K a r a b o	N - K a r a b o
d i t s h e b e l e t s o n g	d i - t s h e b e l e t s o n g
d i r a s i t i	d i - r a s i t i
k g o n w e	k g o n - w - e
a t i s a	a t - i s - a
d i t l a m o r a o	d i - t l a m o r a o
d i a	d i - a
M m e s a	M m e s a
l o k i s a	l o k - i s - a
s e b o p e h o	s e - b o p e h o
p o r o f a e l e	p o r o f a e l e
l e k a n a	l e k - a n - a
p h e t h w a	p h e t h - w - a
a h l o l e l w a	a h l o l - e l - w - a
s h e b i l e n g	s h e b - i l - e - n g
n g o l w a	n g o l - w - a
k g e f u t s o	n - k g e f u t s o
t l a m e h i l e	t l a m - e h - i l - e
p h e t h a h a l e n g	p h e t h - a h a l - e - n g
d i o f i s i n g	d i - o f i s i n g
b o h l a s w a	b o - h l a s w a
t s a m a y a n g	t s a m a y - a - n g
K G A O L O	N - K G A O L O
t l o h e l a n g	t l o h - e l - a - n g
p o l e l o	n - p o l e l o
D R C	D R C
d i k r e d i t i	d i - k r e d i t i
t a e l o n g	n - t a e l o n g
D i e n t e	d i - e n t e
t s a m a i l e	t s a m a - i l - e
m o n a t e	m o - n a t e
d i k o t w a n a	d i - k o t w a n a
e t s a h a l a n g	e t s - a h a l - a - n g
t e s e l l o	n - t e s e l l o
t l e l a n g	t l - e l - a - n g
C O S A S	C O S A S
e k e d i t s e n g	e k e - d i t s - e - n g
k o p a k o p a n n g w a	k o p a k o p a n - n g - w - a
N t h o	N - t h o
s e t s h a b e n g	s e - t s h a b e n g
l e o t o	l e - o t o
t s w e l l a	t s w - e l - l - a
S e r v a a s	S e r v a a s
B o n g w a n a	b o - n g w a n a
s e p h i r i	s e - p h i r i
d i k a h a r e	d i - k a h a r e
b u h o w a	b u h - o w - a
m a w a	m a - w a
t h u s i t s w e	t h u s - i t s - w - e
S E D A	S E D A
m o t s w a d i	m o - t s w a d i
d i i n t a s e t e r i	d i - i n t a s e t e r i
b a t j h u t j h i s i	b a - t j h u t j h i s i
h a s a n n g w a	h a s a - n n g - w - a
m e n y e n y e t s i	m e - n y e n y e t s i
L u c a s	L u c a s
K a n o	N - K a n o
h l o n g w a	h l o n g - w - a
B a m e d i s i	b a - m e d i s i
e t e l w a n g	e t - e l - w - a - n g
i t e a n y a n g	i - t e a - n y - a - n g
k e n e	k e n - e
C a r r o l l	C a r r o l l
S A M S A	S A M S A
b a l e m i	b a - l e m i
U S A	U S A
h a n a	h a n - a
k e n e t s e n g	k e n - e - t s - e - n g
p o r o s e n t e	p o r o s e n t e
M o l o t o	m o l o t o
h l a l o s a n g	h l a l o s - a - n g
t s h a b i s w a n g	t s h a b - i s - w - a - n g
m a q e b a	m a - q e b a
D i t o n a k g o l o	d i - t o n a k g o l o
L e k o t a	L e k o t a
l a h l w a	l a h l - w - a
v a n	v a n
b u k e n g	b u k e n g
k h a r i k h u l a m o n g	k h a r i k h u l a m o n g
b o t h o	b o - t h o
M a i t e k o	m a - i t e k o
f o l o u r u	f o l o u r u
k o p a k o p a n e	k o p a k o p - a n - e
s e b e d i t s w e	s e b e d - i t s - w - e
f i h l e t s e n g	f i h l - e - t s - e - n g
R I A	R I A
i t e k a n e l a	i - t e k - a n - e l - a
b o n d o	b o n d o
m a s e p a l a	m a s e p a l a
P a t	P a t
I r a q	I r a q
s h e b e	s h e b - e
i t h u t i l e n g	i - t h u t - i l - e - n g
r o m e l l a	r o m - e l - l - a
s e t l a n k a n a	s e - t l a n k a n a
b a k a n g	b a k - a - n g
m a k a l e n g	m a - k a l e n g
t s a m a i s a n g	t s a m a - i s - a - n g
b o k o l o n i a l e	b o - k o l o n i a l e
o m f o l o p o	o m f o l o p o
d i r a p o t o n g	d i - r a p o t o n g
d i p o n t s h o	d i - p o n t s h o
d i p i l o t	d i - p i l o t
q e t e l l a	q e t - e l - l - a
D i r e k o t o	d i - r e k o t o
t s w a l a n o	t s w a l a n o
b o l e k a n e	b o - l e k a n e
t l w a e t s a	t l w a e - t s - a
e k e t s w a	e k e t s - w - a
b o i t h a b i s o	b o - i t h a b i s o
f e t o h e n g	f e t - o h - e - n g
k e l e l l o	n - k e l e l l o
M o l a o t h e o	m o - l a o t h e o
d i k o p o	d i - k o p o
s i y o	s i y o
d i t s h i t i s o	d i - t s h i t i s o
b o e m o	b o - e m o
s e h l o h o	s e - h l o h o
q e t a	q e t - a
l e n a m a	l e - n a m a
k a m e h o	n - k a m e h o
I R P	I R P
p i t s o n g	n - p i t s o n g
o f e	o f e
t l o l a n g	t l o l - a - n g
b a i p a b o d i	b a - i p a b o d i
m e n e	m e n e
S c h i p p e r s	S c h i p p e r s
m o t j h a	m o t j h a
s e k h a h l a	s e - k h a h l a
s a e n w a	s a e n - w - a
D i t s h e b e l e t s o n g	d i - t s h e b e l e t s o n g
d i e h i s a	d i e h - i s - a
l a t o t s e	l a t o - t s - e
m a b o p o	m a - b o p o
m o l a o d i	m o - l a o d i
l a t e l a n a	l a t e l - a n - a
h l a h i s i t s w e	h l a h - i s - i t s - w - e
f i h l a n g	f i h l - a - n g
m o r e r o n g	m o - r e r o n g
f e l e n g	f e l - e - n g
r a p o r o t o n g	r a p o r o t o n g
M e h o p o l o	m e - h o p o l o
s i i l e	s i - i l - e
E b a n g	E - b - a - n g
d i l i n k	d i - l i n k
t h o b a l a n o	t h o b a l a n o
r a s a e n s e	r a - s a e n s e
t h e o s a	t h e o - s - a
s e p e t l e l e	s e - p e t l e l e
e k e l l e t s w a	e k e l - l e t s - w - a
M a k g o t l a	m a - k g o t l a
p h i h l e l o	n - p h i h l e l o
d u m e l l e t s w e	d u m e l - l - e t s - w - e
l e b e l l e t s w e n g	l e b e l - l - e t s - w - e - n g
S e t s w a k a n t l e	s e - t s w a k a n t l e
M o e l e t s i	m o - e l e t s i
D a d o o	D a d o o
m o o f i s i r i	m o - o f i s i r i
m o f u t e n g	m o f u t e n g
f e t a n g	f e t - a - n g
i n s t i t j h u s h e n e	i n s t i t j h u s h e n e
T u n i s i a	T u n i s i a
d i t h u n y a	d i - t h u n y a
b o b e	b o - b e
K h o u t a	K h o u t a
t s o s o l o s a	t s o - s - o l o - s - a
q a l e l l e t s e	q a l - e l - l - e t s - e
D i k h o l e t j e	d i - k h o l e t j e
a r o l w a	a r o l - w - a
l e b e l l e t s w e	l e b e l - l - e t s - w - e
r e k i l w e n g	r e k - i l - w - e - n g
i k o k o b e d i t s e	i - k o k o b e - d i t s - e
t s h o h l i l w e	t s h o h l - i l - w - e
t s h w e n y w a	t s h w e n y - w - a
t e k a	t e k - a
R D P	R D P
b o i k a r a b e l o n g	b o - i k a r a b e l o n g
b a p i s a	b a p - i s - a
m e h o p o l o	m e - h o p o l o
f i h l e l a n g	f i h l - e l - a - n g
B o n n e t e n g	b o - n n e t e n g
d i p h e s e n t e	d i - p h e s e n t e
m o t s a m a o	m o - t s a m a o
t s o t e l l e h e	t s o t - e l - l - e h - e
k g o t h a l e t s o	n - k g o t h a l e t s o
d i e n t a p r i s e	d i - e n t a p r i s e
n g o l l a	n g o l - l - a
t h i b e l e	t h i b - e l - e
q e t i l e	q e t - i l - e
N E P A D	N E P A D
b o n e n g	b o n - e - n g
d i y a n t l e	d i - y a n t l e
n g o d i s w e	n g o - d i s - w - e
n k i l w e	n k - i l - w - e
b u l e h i l e n g	b u l - e h - i l - e - n g
T l a l e h w e n g	T l a l e h - w - e - n g
D i l i n k	d i - l i n k
i k e t s e t s a	i k - e t s - e t s - a
u n a n g	u n - a - n g
d i t i k o l o h o	d i - t i k o l o h o
b o k e l l a n a	b o k - e l l - a n - a
D i r o y a l t y	d i - r o y a l t y
f e t i s e t s w a	f e t - i s - e t s - w - a
d i a k h a e v e	d i - a k h a e v e
l e b o k o s o n g	l e - b o k o s o n g
b o n w a n g	b o n - w - a - n g
s a l l e t s e n g	s a l - l - e t s - e - n g
s a e n w e	s a e n - w - e
a m o h e l e	a m o h e l - e
B a p r e s i d e n t e	b a - p r e s i d e n t e
m a t l o l e	m a - t l o l e
l a b a l a b e l l a	l a b a l a b - e l - l - a
k o n t r a k a	k o n t r a k a
m a r a r o	m a r a r o
t j h o n n e	t j h o n - n - e
d i d e b e n t u r e	d i - d e b e n t u r e
e n w a	e n w a
m a i k e m i s e t s o n g	m a - i k e m i s e t s o n g
e t a	e t - a
k e n y e l e t s o	k e n y e l e t s o
h u l e l a	h u l - e l - a
b u e	b u - e
k o p a n w e n g	k o p a n - w - e - n g
p h e p h e t s a	p h e p h e t s - a
d i m i l i o n e t s e	d i - m i l i o n e t s e
d i k h e m i k a l e	d i - k h e m i k a l e
h l a l o s e	h l a l o s - e
M a k g e t l o	m a - k g e t l o
b o t s h e p e h i	b o - t s h e p e h i
T s h a b o	T s h a b o
l e k g a t h e	l e - k g a t h e
a n a n e l a n g	a n a n e l - a - n g
m a h a k w e	m a - h a k w e
M o a m o h e d i	m o - a m o h e d i
m o t h o	m o - t h o
m a q u l w a n e n g	m a - q u l w a n e n g
r e j i s t a r a	r e j i s t a r a
m e e d i n g	m e - e d i n g
j e l e n g	j - e l - e - n g
C i t y	C i t y
C O M E S A	C O M E S A
t s a m a e l a n a n g	t s a m a - e l - a n - a - n g
n k u w e	n k - u w - e
b a r u t e h i	b a - r u t e h i
h a e s a l e	h a e s a l e
l e b i t s o n g	l e - b i t s o n g
f a n y e h w a	f a n y e h - w - a
t h e i l w e	t h e - i l - w - e
m o n a h a n o n g	m o - n a h a n o n g
m m o b a	m o - m m o b a
t s h e h o l l o	n - t s h e h o l l o
a k h a u n t u	a k h a u n t u
b u i s a n w a	b u - i s - a n - w - a
m a b o n e	m a - b o n e
k o p a n e	k o p a n - e
d i k a d i m o	d i - k a d i m o
i k w a l l e t s e	i - k w a - l - l e - t s - e
q a d i s a	q a d - i s - a
i t e k a n e l a n g	i - t e k - a n - e l - a - n g
K a r o l e l a n o	N - K a r o l e l a n o
h o s e n g	h o s e n g
b u s a	b u s - a
s i r e l e t s e h a n g	s i r - e l - e t s - e h - a - n g
d i k g w e d i n g	d i - k g w e d i n g
b a q o b e l l i	b a - q o b e l l i
h l a k o l w a	h l a k o l - w - a
q e t o n g	q e t o n g
t s h w e r e n g	t s h w - e r - e - n g
m o k o t l a	m o - k o t l a
p e e l e t s o	n - p e e l e t s o
d i w e k e s h o p o	d i - w e k e s h o p o
i k a r a b e l l a	i k - a r a b - e l - l - a
e l e	e l - e
t s h w e n y e h i l e	t s h w e n y - e h - i l - e
a n a n e t s w e	a n a n e - t s - w - e
P o r t	P o r t
i p e h e l a	i - p e h - e l - a
l a t e l l a n a n g	l a t e l - l - a n - a - n g
t s h e p e l a	t s h e p - e l - a
n t s h u w a	n t s h - u w - a
l e j w a l e	l e - j w a l e
r e k i s a	r e k - i s - a
d i p h o f u	d i - p h o f u
d i p h e t h o n g	d i - p h e t h o n g
B r i t h a n i	B r i t h a n i
p h e l e t s o n g	p h e l e t s o n g
d i t l h a s e l o	d i - t l h a s e l o
f i l e n g	f - i l - e - n g
m o u s e	m o u s e
d i p h e t o l o	d i - p h e t o l o
q a l a n g	q a l - a - n g
b r o w s e r	b r o w s e r
l e f e l a	l e f - e l - a
b o l o k i l w e	b o l o k - i l - w - e
s e t s w a k a n t l e	s e - t s w a k a n t l e
E a s t	E a s t
l e u b a	l e - u b a
k g e t h i l e n g	k g e t h - i l - e - n g
i n g o d i s e	i - n g o d - i s - e
k e n y a n g	k e - n y - a - n g
f u w e	f - u w - e
u t l w i s a	u t l w - i s - a
d i t s e k o	d i - t s e k o
m m a r a k a	m o - m m a r a k a
D i t i f i k e i t i	d i - t i f i k e i t i
m o l e f i	m o - l e f i
s i r e l e d i t s w e n g	s i r - e l - e d - i t s - w - e - n g
m m o h o l e	m m o h o l e
d i p o l a n t e	d i - p o l a n t e
b a i t e d i	b a - i t e d i
a k o f i s a	a k o f - i s - a
K w a t s i	K w a t s i
D i b o k a	d i - b o k a
f e t i s w a	f e t - i s - w - a
t i i s e d i t s w e n g	t i - i s - e d - i t s - w - e - n g
r e k i s w a n g	r e k - i s - w - a - n g
l e k g e t h o n g	l e - k g e t h o n g
m o i k o p e d i	m o - i k o p e d i
m a t s h w e n y e h o	m a - t s h w e n y e h o
i p e h e l o	i p e h e l o
t o n o b a n k e n g	t o n o b a n k e n g
h l a l o s w a	h l a l o s - w - a
D i t j h a n k a n a	d i - t j h a n k a n a
h l o m p h e	h l o m p h - e
m o l o t a	m o - l o t a
d i k e r e i t i n g	d i - k e r e i t i n g
k h a m p a n i n g	k h a m p a n i n g
S A N D F	S A N D F
i t e k a n e l e	i - t e k - a n - e l - e
k g o t s o f e t s e n g	k g o t s o - f - e t s - e - n g
q o s w a	q o s - w - a
d i b e o	d i - b e o
D i t l e t l e b o	d i - t l e t l e b o
b o 2 0	b o - 2 0
p o t l a k i s w e	p o t l a k - i s - w - e
h u l w a	h u l - w - a
k h a h l a n o	n - k h a h l a n o
d i M u l t i P u r p o s e	d i - M u l t i P u r p o s e
s i l a h a n t s w e	s i l - a h a n - t s - w - e
h l a p i	h l a p i
m a b a i	m a - b a i
q h e l e l a	q h e l - e l - a
n y a l e l l a n a	n y a l - e l - l - a n - a
h l a b a n g	h l a b - a - n g
I E C	I E C
i k a m a h a n y a	i k - a m - a h a - n y - a
b o p o r o f e s h e n e	b o - p o r o f e s h e n e
T l w a e t s o	T l w a e t s o
p h e t a p h e t o	p h e t a p h e t o
f a n w e n g	f - a n - w - e - n g
m e f e l o n g	m e - f e l o n g
t l o t l w a n g	t l o t l - w - a - n g
D i k o m i t i	d i - k o m i t i
m o s i f a	m o - s i f a
m o k g e n g	m o - k g e n g
H a e b a	H a e b a
D i k g a t e l o p e l e	d i - k g a t e l o p e l e
m e n y a k o	m e - n y a k o
i p i l e t s a	i - p i l - e t s - a
h a r e	h a r e
d i k a b o	d i - k a b o
k g u t l i s w a n g	k g u t l - i s - w - a - n g
d i i n t a s t e r i	d i - i n t a s t e r i
f e l e t s e n g	f e l - e - t s - e - n g
s e d i k a	s e - d i k a
d i t s h e n y e h e l o	d i - t s h e n y e h e l o
k g a f e t s a k g a f e t s a	k g a f e t s a k g a f e t s a
m e l a e t s a	m e - l a e t s a
b o i t s i b i s o	b o i t s i b i s o
p h e t h e l w e	p h e t h - e l - w - e
t l i s e t s a	t l - i s - e t s - a
n t o	n t - o
h a p e l w a	h a p - e l - w - a
d i d i k a d i k w e	d i - d i k a d i k w e
B o h a	B o h - a
p h a t l a l a t s e	p h a t l a l a - t s - e
b o k g u t s h w a n e	b o k g u t s h w a n e
e l e n g	e - l e - n g
b a r u p e l l i	b a - r u p e l l i
K a r o l w a n a	N - K a r o l w a n a
D i r a p o r o t o n g	d i - r a p o r o t o n g
d i t l h a p i	d i - t l h a p i
D i t e b o h i s o	d i - t e b o h i s o
s e k e p e	s e - k e p e
w e b s a e t e	w e b s a e t e
l e f u	l e - f u
m o h l o p h o l l i	m o - h l o p h o l l i
D i e n t r y	d i - e n t r y
d i h l o o h o	d i - h l o o h o
H l o k o l o s i	b o - H l o k o l o s i
C e n t r a l	C e n t r a l
d i t i f e l o	d i - t i f e l o
m a m e l w a	m a m e l - w - a
n n e t e f a t s a	n n e t e - f a - t s - a
M o g a l e	m o g a l e
l e k i l e	l e k - i l - e
m o e l e l o	m o - e l e l o
b u l w a	b u l - w - a
t h u p e l o n g	n - t h u p e l o n g
k w a l l w a	k w a l - l - w - a
s h e b i l w e	s h e b - i l - w - e
A c r o b a t	A c r o b a t
t i i l e	t i - i l - e
E D I	E D I
k g u t l i s a	k g u t l - i s - a
p h u t h e h o n g	p h u t h e h o n g
P e o	P e o
d i M u l t i p u r p o s e	d i - M u l t i p u r p o s e
J o h n n y	J o h n n y
t l i l i k e	t l i l i k - e
p a t w a	p a t - w - a
b a p a t s w a	b a p a t s - w - a
k e n a n g	k e n - a - n g
h l w a u w e	h l w a - u w - e
t e r a s e t e	t e r a s e t e
f u m a n t s h a	f u m a n - t s h - a
d r i v e	d r i v e
k e n y e l e t s e	k e - n y - e l - e t s - e
l e q w e t h a	l e - q w e t h a
j a	j - a
p h e h i s a n o	p h e h i s a n o
m a o b a n e	m a o b a n e
M o e m e d i	m o - e m e d i
T h e l e f o u n u	T h e l e f o u n u
k g e t h a	k g e t h - a
d i k o l o t o	d i - k o l o t o
k g a l e	k g a l e
t h e r o	n - t h e r o
p a l o y o h l e	n - p a l o y o h l e
n t l a f a t s e	n t l a - f a - t s - e
n a t e f e l a n g	n a t e - f - e l - a - n g
h a t s e d i t s w e	h a t s e - d i t s - w - e
t o t o b a t s o	t o t o b a t s o
t l u n g	n - t l u n g
b o i t s e b a h a t s o n g	b o - i t s e b a h a t s o n g
f o s i l i	f o s i l i
D i I R P	d i - I R P
d i s e k o n d a r i	d i - s e k o n d a r i
b a t l e h a	b a t l - e h - a
k a t a m e l o	n - k a t a m e l o
t h e o h a	t h e o h - a
d i t e m o s o n g	d i - t e m o s o n g
l a t e t s e	l a t e - t s - e
s h e b a n w e n g	s h e b - a n - w - e - n g
m o t h a m o	m o - t h a m o
d i g r e e	d i g r e e
t l o l w a n g	t l o l - w - a - n g
P A N S A L B	P A N S A L B
k e n y e l l e t s w a	k e - n y - e l - l - e t s - w - a
P a s e p o t e	P a s e p o t e
k g o n a h a l a	k g o n - a h a l - a
s e m m u s o	s e - m m u s o
s e t i f i k e i t i n g	s e - t i f i k e i t i n g
t a t e l l a n o	n - t a t e l l a n o
s e t o k o	s e - t o k o
G o m o m o	G o m o m o
b a l l e t s w e	b a l - l - e t s - w - e
P h e d i s a n o	P h e d i s a n o
k w a l l e t s w e n g	k w a l - l - e t s - w - e - n g
m o t s h o	m o t s h o
f e t a	f e t - a
j a r i l e n g	j a r - i l - e - n g
k g i n w e	k g i n - w - e
h l a l o s i t s w e n g	h l a l o s - i t s - w - e - n g
t a r g e t	t a r g e t
D i n o m o r o	d i - n o m o r o
k a h o b o t j h a	n - k a h o b o t j h a
K g o k a h a n o	n - K g o k a h a n o
n q e n g	n - q e n g
H o d i m o d i m o	h o - d i m o d i m o
d i k e r e i t i	d i - k e r e i t i
b o m o	b o - m o
a m o h a	a m o h - a
C I T E S	C I T E S
n w e s e t s a	n w - e s - e t s - a
k g a b a h a n y a	k g a b - a h - a n y - a
m o k g a t l o	m o - k g a t l o
p h e t h e t s e n g	p h e t h - e t s - e - n g
D i t l h o d i s a n o	d i - t l h o d i s a n o
m e k g e n g	m e - k g e n g
p o r a f e t e	p o r a f e t e
P r o f e s h e n e	P r o f e s h e n e
q u l l u n g	q o l l o n g
T s h o s o	T s h o s o
m o p h a t o	m o - p h a t o
r o m e l w a n g	r o m - e l - w - a - n g
i t o t o b a t s a	i - t o t o b a - t s - a
l e k a l e n g	l e - k a l e n g
b o i p h i h l e l o n g	b o - i p h i h l e l o n g
d i S E T A	d i - S E T A
m a a n o n g	m a - a n o n g
h o b a	h o b a
D i t e m a n a	d i - t e m a n a
P r o f e s s i o n a l	P r o f e s s i o n a l
L e q e p h e	l e - q e p h e
i n k e l a n g	i - n k - e l - a - n g
f o k o d i t s e	f o k o d - i t s - e
f e t o l a	f e t o l - a
G i n i e l	G i n i e l
S e h l o m a t h i s o n g	s e - h l o m a t h i s o n g
i t l a m a n g	i - t l a m - a - n g
k g o t h a l e t s w a n g	k g o t h a l - e - t s - w - a - n g
J 2 9 4	J 2 9 4
l e n a n e o o	l e - n a n e o o
l a t e l w a	l a t e l - w - a
h o d i m o d i m o	h o - d i m o d i m o
m o k a t o	m o - k a t o
M o p h a t o n g	m o - p h a t o n g
q o s o	q o s o
p o r o f a e l e n g	p o r o f a e l e n g
a m a n g	a m - a - n g
k g a e l l o	n - k g a e l l o
d i g i s a r a	d i - g i s a r a
m a t a n y o l a	m a t a n y o l a
k a h i s a n o	n - k a h i s a n o
b o h e h a n g	b o h - e h - a - n g
b o t e k g e n i k i	b o - t e k g e n i k i
a j w a	a j - w - a
s e b e d i s a n g	s e b e d - i s - a - n g
i k e m e l a	i k - e m - e l - a
f o k o t s e n g	f o k o - t s - e - n g
b a b e e l e t s i	b a - b e e l e t s i
n q a n e	n - q a n e
n t s h w e	n t s h - w - e
b e h i l w e	b e h - i l - w - e
p r o p a t i	p r o p a t i
p h a t h a h a t s o	p h a t h a h a t s o
m o n y a	m o n y - a
q h a q h e h a	q h a q h - e h - a
m m a p a	m m a p a
k e n y e l l e t s a n g	k e - n y - e l - l - e t s - a - n g
G C I S	G C I S
r o b e d i	r o b - e d i
b a s a r i	b a s a r i
m e l a o	m e - l a o
p a k e n g	p a k e n g
b o t e l e l e	b o - t e l e l e
M L R A	M L R A
h l o p h i s w a n g	h l o p h - i s - w - a - n g
B o r a b e	b o - r a b e
h i r e	h i r - e
d i a d v o k h e i t i	d i - a d v o k h e i t i
t e a n a	t e - a n - a
s e T s o n g a	s e - T s o n g a
n k u w a	n k - u w - a
t h o t h a	t h o t h - a
b a a h i n g	b a - a h i n g
t s	t s
b a e t e l e d i p e l e	b a - e t e l e d i p e l e
h l o k a h a l a n g	h l o k - a h a l - a - n g
n e h w a n g	n e h - w - a - n g
D i s a m p o l e	d i - s a m p o l e
s a p o t a	s a p o t - a
h l a h l o b e	h l a h l o b - e
S o b u k w e	S o b u k w e
s e t s o n g	s e - t s o n g
m a t s h o l o	m a - t s h o l o
d i k g e o	d i - k g e o
P e o p l e ' s	P e o p l e ' s
n t s h e t s o p e l e y a	n t s h e t s o p e l e y a
T E K O L O	N - T E K O L O
S e b u i	s e - b u i
b a t h o b a t s h o	b a - t h o b a t s h o
b o i t s h e p o	b o - i t s h e p o
l e g	l e g
h a n g a t a	h a n g a t a
t s h w a n e l e h i l e	t s h w a n e l - e h - i l - e
K o u n g	K o u n g
h a u w e n g	h a u - w - e - n g
d i k a r a b o	d i - k a r a b o
k a n a n e l o	n - k a n a n e l o
m o h o p o l o	m o - h o p o l o
e t s a h a l a	e t s - a h a l - a
d i t e r a s e t e	d i - t e r a s e t e
b e h e t s w e	b e h - e - t s - w - e
A m e r i c a	A m e r i c a
S a h a r a	S a h a r a
d i k g e t h o n g	d i - k g e t h o n g
F N B	F N B
h o r a	h o r a
n t s h i t s e n g	n t s h - i t s - e - n g
s u p a	s u p - a
s e t e r e k e n g	s e - t e r e k e n g
S e s o t h o	s e - s o t h o
s u p a n a	s u p - a n - a
m o h a n y e t s i	m o - h a n y e t s i
t l i s w e	t l - i s - w - e
f e t o h i l e n g	f e t - o h - i l - e - n g
p h e t h a h a t s o	p h e t h a h a t s o
f e p e l a n g	f e p - e l - a - n g
t o k i s o	n - t o k i s o
d i n o k w a n e	d i - n o k w a n e
p h o m o l e	p h o m o l - e
8 5 %	8 5 %
k u t w i s i s o	k u t w i s i s o
V i l l i e r s	V i l l i e r s
s i t i s a n a n g	s i t - i s - a n - a - n g
k o l o t a	k o l o t - a
d i k g o k a h a n o	d i - k g o k a h a n o
n g o d i s o n g	n - n g o d i s o n g
b e y a n g	b e y - a - n g
d i k g w e r e k g w e r e	d i - k g w e r e k g w e r e
t l i l o	t l - i l - o
s u s u m e t s a	s u s u m - e t s - a
m o t s w a k o	m o - t s w a k o
r u t w a n g	r u t - w - a - n g
M a i k a r a b e l o	m a - i k a r a b e l o
n e h e l w a n g	n e h e l - w - a - n g
t a d i m a	t a d i m - a
t l i s a	t l - i s - a
B o t l o l o	b o t l o l o
b o t s i s o	b o - t s i s o
d i t e f i k e i t i	d i - t e f i k e i t i
i n t s h e t s a	i - n t s h - e t s - a
s e t s h e l o	s e - t s h e l o
m a n o l l o	m a - n o l l o
i k o b e l a n g	i - k o b - e l - a - n g
E l i z a b e t h	E l i z a b e t h
l e f e l l a	l e f - e l - l - a
T i r o	T i r o
f u p u t s w a	f u p u t s - w - a
M o t l a t s a	m o - t l a t s a
m a h a t o	m a - h a t o
s e h l e k e h l e k e	s e - h l e k e h l e k e
P r o t h o k h o l o	P r o t h o k h o l o
k a h o n g	n - k a h o n g
m a m a r e t s w e n g	m a m a r e - t s - w - e - n g
M e r i a n a	m e - r i a n a
i t o k i s e d i t s e	i - t o k - i s - e - d i t s - e
n g o d i s i t s w e	n g o - d i s - i t s - w - e
t h e l e f o u n u	t h e l e f o u n u
A l b e r t	A l b e r t
E m b a s i	E m b a s i
l a o l w a n g	l a o l - w - a - n g
b a k i l e	b a k - i l - e
r a d i l w e n g	r a d - i l - w - e - n g
I n s t i t j h u t e	I n s t i t j h u t e
u t l w i s i s w a	u t l w - i s - i s - w - a
p h e t h a n g	p h e t h - a - n g
b o f o k o d i n g	b o - f o k o d i n g
i t h u t a n g	i - t h u t - a - n g
D A 1 8 5	D A 1 8 5
K l i p f o n t e i n	K l i p f o n t e i n
s e b e t s a n w e n g	s e b e t s - a n - w - e - n g
d i n t l a f a t s o	d i - n t l a f a t s o
s e m e l a	s e - m e l a
m e t s i n g	m e - t s i n g
s e q o	s e - q o
B a j e t e	B a j e t e
d i C E O	d i - C E O
p a l l o	n - p a l l o
m e m a	m e m - a
t l i s w a	t l - i s - w - a
t h u n y a n g	t h u n y - a - n g
A B S A	A B S A
d i s o s a	d i - s o s a
d i n t j a	d i - n t j a
k e t s a	k e t s - a
b u t t o n	b u t t o n
h o h o l o	h o h o l o
s e b e d i s i t s w e	s e b e d - i s - i t s - w - e
t h e k o l o h e l o	n - t h e k o l o h e l o
S e q a t j w a	s e - q a t j w a
s e a r c h	s e a r c h
d i k h o p i	d i - k h o p i
m a A f r i k a n e r	m a - A f r i k a n e r
m o t s h w a r i	m o - t s h w a r i
b o k g a b a n e	b o - k g a b a n e
d i i m b i z o	d i - i m b i z o
K o r a n t a	K o r a n t a
q a d i l w e	q a d - i l - w - e
k o u n g	k o u n g
d i p a m p i r i	d i - p a m p i r i
n y e t s e	n y - e t s - e
k g w e b i s a n o	n - k g w e b i s a n o
m a A f r i k a	m a - A f r i k a
t o b a n e	t o b - a n - e
m a n e	m a n e
s o h l e	s o h l e
n t s a n e	n t s a n - e
d i f o r o m o	d i - f o r o m o
t s w e t s w e n g	t s w - e t s - w - e - n g
m o h w a n t o	m o - h w a n t o
m a s h a l a	m a - s h a l a
d i f o r o m o n g	d i - f o r o m o n g
i t h a p o l l a	i - t h a p - o l l - a
h l a h i l e	h l a h - i l - e
A d v a n c e d	A d v a n c e d
M o k g a h l e l o	m o - k g a h l e l o
J e n a l e	J e n a l e
s e t e f i k e i t i	s e - t e f i k e i t i
b e n t e	b e n t e
t s a m a i s a n o n g	t s a m a i s a n o n g
t s e b o n g	t s e b o n g
f u m a n w e	f u m a n - w - e
n q e	n - q e
w e b s a e t e n g	w e b s a e t e n g
l e b a h a n y a	l e b - a h - a n y - a
p o n e l o p e l e	n - p o n e l o p e l e
w i l i	w i l i
t s h w e n y a n g	t s h w e n y - a - n g
d i p h i h l e l o	d i - p h i h l e l o
n k a n g	n k - a - n g
R u s s i a	R u s s i a
r e r w a n g	r e r - w - a - n g
d i t a t t o o	d i - t a t t o o
d i p h u p u t s o n g	d i - p h u p u t s o n g
n k w a	n k - w - a
p o t l a k i l e	p o t l a k - i l - e
b o k a n e	b o k - a n - e
P a l o y o h l e	N - P a l o y o h l e
W T O	W T O
u n n e n g	u n - n - e - n g
b a p i s w a	b a p - i s - w - a
m o k g a h l e l o n g	m o - k g a h l e l o n g
l w a n t s h a n g	l w - a n - t s h - a - n g
B a t l i s i s a	B a t l - i s - i s - a
m m a k g o n t h e	m m a k g o n t h e
a m e h i l e	a m - e h - i l - e
b o n a n g	b o n - a - n g
k o p a n e t s w e	k o p a n - e - t s - w - e
d i p o r o f e n s i	d i - p o r o f e n s i
t j h o n n e n g	t j h o n - n - e - n g
q o s w e	q o s - w - e
k e n y e l l e t s a	k e - n y - e l - l - e t s - a
s i i l e n g	s i - i l - e - n g
h l a h i l e n g	h l a h - i l - e - n g
n g o l w a n g	n g o l - w - a - n g
b o l a o d i n g	b o - l a o d i n g
P h e t h e l a	P h e t h - e l - a
B o m e n e m e n e	b o - m e n e m e n e
t e f e l o	n - t e f e l o
B a e l e t s i	b a - e l e t s i
k h o m r e i t i	k h o m r e i t i
k g u t l i s e t s w a	k g u t l - i s - e t s - w - a
D i p o e l o	d i - p o e l o
S A C N A S P	S A C N A S P
p e l a	p e l a
f o k o t s e	f o k o t s - e
b o s o l l a t l h a p i	b o - s o l l a t l h a p i
b o s h o d u	b o - s h o d u
h l a h l o b o	h l a h l o b o
k a n a	k a n a
m o a m o h e d i	m o - a m o h e d i
t e k o k e r a s i	t e k o k e r a s i
n g o d i s w a	n g o - d i s - w - a
t s a m a e l a n e	t s a m a - e l - a n - e
l e b e l e t s w e n g	l e b e l - e - t s - w - e - n g
t e f o	n - t e f o
h l o k w a n g	h l o k - w - a - n g
m a m e l e	m a m e l - e
d i t l h o k a	d i - t l h o k a
d i f e	d i f e
m a r e n a n a	m a - r e n a n a
a k h a o n t e n g	a k h a o n t e n g
t l a t s e l e t s o	t l a t s e l e t s o
t l a l e h i l e n g	t l a l e h - i l - e - n g
D i k a r e t e	d i - k a r e t e
b o h o l o n g	b o - h o l o n g
t l a t s i t s w e n g	t l a - t s - i t s - w - e - n g
b a m e d i s i	b a - m e d i s i
s h i f t	s h i f t
m a t l a f a t s o n g	m a - t l a f a t s o n g
n g o l e h a	n g o l - e h - a
s e e t s a n a	s e - e t s a n a
d i n a h e n g	d i - n a h e n g
n t l h a	n - t l h a
l e f a	l e - f a
B a e t s a d i k o p o	b a - e t s a d i k o p o
m e s i f a	m e - s i f a
k e n g w e	k e n g - w - e
P h o l i s i	P h o l i s i
M o k h o m i s h e n a r a	m o - k h o m i s h e n a r a
e t e l l e t s w e n g	e t - e l - l - e t s - w - e - n g
m a d i	m a - d i
b o n e	b o n - e
b o l a i l w e n g	b o l a - i l - w - e - n g
t s h e l e l a	t s h e l - e l - a
k g o p o	k g o p o
f e t o l e l w e	f e t o l - e l - w - e
k g u t l e t s e	k g u t l - e - t s - e
k w a l w a	k w a l - w - a
e m e i l e	e m e i l e
p e h e l e t s o	n - p e h e l e t s o
n k i l e	n k - i l - e
t e m o t h u o	n - t e m o t h u o
Z a m b i a	Z a m b i a
m o f u t a	m o - f u t a
m m e t s e	m o - m m e t s e
s e h l a h i s w a	s e - h l a h i s w a
T e f e l l o	N - T e f e l l o
T a e l o	n - T a e l o
D i f o m e t e	d i - f o m e t e
l e f a n g	l e f - a - n g
t s e k a n g	t s e k - a - n g
k o n t e r a k a	k o n t e r a k a
M o l a o n g	m o - l a o n g
R a k e b i	R a k e b i
t e n y e t s e h a n g	t e n y e t s - e h - a - n g
B o i p h i h l e l o n g	b o - i p h i h l e l o n g
d i j a l o	d i - j a l o
a m a h a n n g w a n g	a m - a h a n - n g - w - a - n g
l o k e l w a	l o k - e l - w - a
p h o f u	p h o f u
h l o k o l o s i	b o - h l o k o l o s i
t s h w a n e l w a	t s h w a n e l - w - a
d i k a m a n o n g	d i - k a m a n o n g
n g o d i s e	n g o - d i s - e
D i p a l l o	d i - p a l l o
K g i r o	n - K g i r o
t s e k w a n g	t s e k - w - a - n g
B u k a	B u k a
d i t l h o k e h o	d i - t l h o k e h o
M o n g o l o	m o - n g o l o
t s h e p i s i t s e n g	t s h e p - i s - i t s - e - n g
t j h e s e h o	n - t j h e s e h o
M a r g e m a n	M a r g e m a n
a k g e n t e	a k g e n t e
k e r e i t i n g	k e r e i t i n g
m o t l e m o t l e	m o t l e m o t l e
I l o	I l - o
t j h e k e	t j h e k e
D i a d o p s h e n e	d i - a d o p s h e n e
R a p o r o t o	R a p o r o t o
l e f i s w a n g	l e f - i s - w - a - n g
K o n d l o	K o n d l o
t j h e n t j h a	t j h e n t j h - a
t l a m o	t l a m o
m m a s e t e r a t a	m m a s e t e r a t a
e n g	e n g
a b e l a n w a	a b - e l - a n - w - a
p a m p i r i n g	p a m p i r i n g
s h e j u l e	s h e j u l e
n y a r o s a n g	n y a r o - s - a - n g
p h a e l l o	n - p h a e l l o
a m a	a m - a
a m e h i l e n g	a m - e h - i l - e - n g
l e b e l a	l e b e l - a
l e b i s w e	l e b - i s - w - e
d i k o u	d i - k o u
l e k w e	l e k - w - e
t j h a e l l w a	t j h a - e l - l - w - a
s e l i p i	s e - l i p i
a b e l a n a	a b - e l - a n - a
l e b e l e t s e n g	l e b e l - e - t s - e - n g
b o d i l e n g	b o d - i l - e - n g
m a t l a l o	m a - t l a l o
b o l a w a	b o l a - w - a
p a l o h o h l e	n - p a l o h o h l e
n y a h l a t s a	n y a h l - a t s - a
l e k u n u t u	l e - k u n u t u
d i k o p a n o	d i - k o p a n o
p r o t h o k h o l o	p r o t h o k h o l o
m a b o t a	m a - b o t a
k g a h l e h o	n - k g a h l e h o
D i k g a u	d i - k g a u
d i p e r s e n t e	d i - p e r s e n t e
h l a k a	h l a k - a
l e r u o	l e - r u o
d i d i k e n g	d i - d i k e n g
S e n y e s e m a n e	s e - n y e s e m a n e
l e t h a t h a m a	l e - t h a t h a m a
D U S	D U S
h l a h e l l e t s e n g	h l a h - e l - l - e t s - e - n g
C e t s h w a y o	C e t s h w a y o
s o t l w a	s o t l - w - a
l e m o h i l e	l e m o h - i l - e
s e k o l o t o	s e - k o l o t o
G u l f	G u l f
t l i l e n g	t l - i l - e - n g
b o t e g n i k i	b o - t e g n i k i
l e b e l w a	l e b e l - w - a
e n e j i	e n e j i
k o n t i n e t e	k o n t i n e t e
m a t l a f a t s w e n g	m a t l a - f a - t s - w - e - n g
l e p o l e s a	l e - p o l e s a
b o m a s h o m e	b o - m a s h o m e
h l a h l o b o n g	h l a h l o b o n g
T e k o l o	N - T e k o l o
S e k e p e	s e - k e p e
b a t l i s i s a	b a t l - i s - i s - a
d i k a r e t e	d i - k a r e t e
s a l l e t s e	s a l - l - e t s - e
t s a m a i s a n a	t s a m a - i s - a n - a
k g a h l a n o	n - k g a h l a n o
h o l e	h o l e
k g o t s o f a l a	k g o t s o - f a l - a
f e t i s i s a n g	f e t - i s - i s - a - n g
d i t l w a e l o	d i - t l w a e l o
m a s i m o n g	m a - s i m o n g
r w a l a	r w a l - a
b o h u w a n g	b o h - u w - a - n g
h o k e l a n g	h o k - e l - a - n g
D i h l o o h o	d i - h l o o h o
b o l o k w e	b o l o k - w - e
Y u s u f	Y u s u f
n t s h e	n t s h - e
m o n w a n g	m o - n w a n g
m e s e b e t s i n g	m e - s e b e t s i n g
K g a t e l o p e l e	N - K g a t e l o p e l e
m a f a t s h e	m a - f a t s h e
l e f e	l e f e
d u m e l e t s w e n g	d u m e l - e - t s - w - e - n g
n y a l a n a	n y a l - a n - a
t l a l e h u w e n g	t l a l e h - u w - e - n g
B o n g a k a	b o - n g a k a
k a m a n o	n - k a m a n o
m m i l a	m o - m m i l a
m o a h o	m o - a h o
M a p e t l a	m a p e t l a
d i s u r i s h i	d i - s u r i s h i
l a t w a n g	l a t - w - a - n g
d i t o n e	d i - t o n e
T e f o	N - T e f o
t h e o h a n g	t h e o h - a - n g
p o e l o	n - p o e l o
m o h a t s a	m o - h a t s a
m a l a r i a	m a - l a r i a
m o e d i	m o - e d i
b o s e t j h a b a	b o - s e t j h a b a
B u r u n d i	B u r u n d i
T l e t l e b o	T l e t l e b o
f a p o h a	f a p o h - a
f i h l e l e	f i h l - e l - e
p h a t l a l a t s w a	p h a t l a l a - t s - w - a
l a o l w a	l a o l - w - a
D i p o r o f e n s i	d i - p o r o f e n s i
d i t a t a i s o	d i - t a t a i s o
b o r o n a	b o - r o n a
n g w a n a	m o - n g w a n a
d i t s h w a n t s h o	d i - t s h w a n t s h o
p o l o k e h o n g	n - p o l o k e h o n g
l e b i s e	l e b - i s - e
b o t j w a	b o t j - w - a
i k g e t h i l e n g	i - k g e t h - i l - e - n g
D i t a t a i s o	d i - t a t a i s o
h l a l o s e d i t s e	h l a l o s - e - d i t s - e
h l o k o m e l e	h l o k o m e l - e
k o t l o	n - k o t l o
m a n y e n y a n e	m a n y e n y a n e
C y n t h i a	C y n t h i a
d i i n s t i t j h u s h e n e	d i - i n s t i t j h u s h e n e
d i f o f u	d i - f o f u
k e l e l l o n g	n - k e l e l l o n g
d i S p r i n g b o k	d i - S p r i n g b o k
b o i k g o p o l e l o	b o - i k g o p o l e l o
B o s b e r a t e n g	b o s b e r a t e n g
d i b o p e h o	d i - b o p e h o
p h o m o l o	p h o m o l o
r a l w a	r a l - w - a
L e f i f i	l e - f i f i
p h e n y o	n - p h e n y o
b o i p e h i	b o - i p e h i
S h e z i	S h e z i
d i n o r o	d i - n o r o
d i p a l e s e n g	d i - p a l e s e n g
h w e b a	h w e b - a
A f i k a	A f i k a
s e b e d i s a	s e b e d - i s - a
d i p r o v e n s e	d i - p r o v e n s e
s e b e d i s e	s e b e d - i s - e
n e h e	n e h - e
m e k g a h l e l a	m e - k g a h l e l a
P o l o k o	N - P o l o k o
f a n g	f - a - n g
s h e b i s i s a	s h e b - i s - i s - a
L e d i b o h o n g	l e - d i b o h o n g
t s h e p o	t s h e p o
f i h l e l l w a	f i h l - e l - l - w - a
s a e n e	s a e n - e
N o b e l e	N o b e l e
k g u t l i s e	k g u t l - i s - e
d ' I v o i r e	d ' I v o i r e
f e l e h e t s w a	f e l e h e t s - w - a
p o s o	p o s o
e b a	e - b - a
b o i k a n o	b o - i k a n o
m a o b a	m a - o b a
h a m p e	h a m p e
k g u t l e l a	k g u t l - e l - a
d i n t h o n g	d i - n t h o n g
M o b u	m o - b u
t h e k i s o	n - t h e k i s o
m a k g e t l o	m a - k g e t l o
b o i t s e b a h a t s o	b o - i t s e b a h a t s o
k o p a n y o	n - k o p a n y o
d i s o c i a l	d i - s o c i a l
b a t o	b a t o
r e n a	r e n - a
d i p h e t o h o n g	d i - p h e t o h o n g
t a b a t a b e l o	t a b a t a b e l o
b a p h e h i s i	b a - p h e h i s i
s h w a h l a	s h w a h l a
L e f u	l e - f u
b a t l i s i s w a	b a t l - i s - i s - w - a
l e q e p h e n g	l e - q e p h e n g
s e V e n d a	s e - V e n d a
b e u w e n g	b e - u w - e - n g
B i l i	B i l i
s e m o l a o	s e - m o l a o
n t s h u w e n g	n t s h - u w - e - n g
y e	y - e
b o i n g o d i s o	b o - i n g o d i s o
F o l a k g a	F o l a k g a
m a h l a l e	m a - h l a l e
r a t a n g	r a t - a - n g
t s h w a n e l e h a n g	t s h w a n e l - e h - a - n g
k g o n t s h a	k g o n - t s h - a
n t s h e t s p e l e	n t s h e t s p e l e
t s e k w a	t s e k - w - a
d i p e n s h e n e	d i - p e n s h e n e
e t e l l e t s e n g	e t - e l - l - e t s - e - n g
p h u m a n t s h o n g	n - p h u m a n t s h o n g
t s a m a i s w a	t s a m a - i s - w - a
m o r a d i	m o - r a d i
t h e r i s a n o	n - t h e r i s a n o
p o r o f e n s i	p o r o f e n s i
d i k g a h l a	d i - k g a h l a
b o p i l e	b o p - i l - e
m o n y w a	m o n y - w - a
d i p o s t a l	d i - p o s t a l
h l a h e l a n g	h l a h - e l - a - n g
m a n g w e l e n g	m a - n g w e l e n g
i p e h w a	i - p e h - w - a
p o t s o	n - p o t s o
i p o t s i s a	i - p o t s - i s - a
a r o l a	a r o l - a
t s e k a	t s e k - a
s i r e l e t s w a	s i r - e l - e t s - w - a
l h a h l o b o	l h a h l o b o
b o m o r a b e	b o - m o r a b e
t s h a e n o	t s h a e n o
l e b o k o s e	l e - b o k o s e
d i t o k o m a m e	d i - t o k o m a m e
i n f l e i s h e n e	i n f l e i s h e n e
t j h e b a h a l o	n - t j h e b a h a l o
d i I R P 6	d i - I R P 6
N a i r	N a i r
t s h e k a t s h e k o	n - t s h e k a t s h e k o
n t s h w a n g	n t s h - w - a - n g
k o p a n e t s e	k o p a n - e - t s - e
m a n a n e o o	m a n a n e o o
S e b o k e n g	S e b o k e n g
C a p e	C a p e
T l h o p h i s o	N - T l h o p h i s o
d i N G O	d i - N G O
d i k o t l o	d i - k o t l o
h a n a n g	h a n - a - n g
a t i s w a	a t - i s - w - a
m o k g u t s h w a n e	m o - k g u t s h w a n e
m o h i r i	m o - h i r i
p o k e l l o	n - p o k e l l o
b o t s w a	b o t s - w - a
D i b o n a s e	d i - b o n a s e
p h e t h w e	p h e t h - w - e
t j h e l e t e n g	t j h e l e t e n g
t l a m e h o	t l a m e h o
D u r b a n	D u r b a n
b o p i l w e	b o p - i l - w - e
m a t l e n g	m a - t l e n g
t i n n g w e n g	t i - n - n g w - e - n g
n g o d i s i t s e n g	n g o - d i s - i t s - e - n g
A l b e r t i n a	A l b e r t i n a
s e h a t s e t s i n g	s e - h a t s e t s i n g
b a h o l o	b a h o l o
M o s i o u a	M o s i o u a
p h u t h i l w e n g	p h u t h - i l - w - e - n g
S e t s h w a n t s h o	s e - t s h w a n t s h o
M o l a w a n a	m o - l a w a n a
b o f u t s a n a	b o - f u t s a n a
k g a p o	n - k g a p o
m a f u r a	m a - f u r a
s e k g a m u	s e - k g a m u
D i k e r e i t i	d i - k e r e i t i
I t e a n y e	I - t e a - n y - e
f e t i s i s a	f e t - i s - i s - a
T i m b u k t u	T i m b u k t u
b a a m o h e d i	b a - a m o h e d i
m p e f a l a	m p e - f a l - a
t s h w a n t s h i s i t s w e n g	t s h w a n - t s h - i s - i t s - w - e - n g
l e i b o l e	l e - i b o l e
d i t a e l o	d i - t a e l o
d i t j h e m b a r e n g	d i - t j h e m b a r e n g
a o	a o
M o t h u s i	m o - t h u s i
b a j a l e f a	b a - j a l e f a
f e t i s e t s a	f e t - i s - e t s - a
f e t e l a	f e t - e l - a
t h a p a m a	t h a p a m a
h o n g	h o n g
q e t e l l e	q e t - e l - l - e
m o h l o l o	m o - h l o l o
t h i b e t s w e	t h i b - e - t s - w - e
e l e t s w a	e l e t s - w - a
n a m m e n g	n a m - m - e - n g
s e t s w a l l e n g	s e - t s w a l l e n g
S e t i f i k e i t e	s e - t i f i k e i t e
t l e t l e b o	t l e t l e b o
l e b i l e	l e b - i l - e
K o p a	K o p - a
t l h o k e h o	n - t l h o k e h o
m o l o m o	m o - l o m o
s o t l w e	s o t l - w - e
t s h e h e t s o n g	t s h e h e t s o n g
k r e d i t i l w e n g	k r e d i t - i l - w - e - n g
k g a n e t s o	n - k g a n e t s o
d i s e b e d i s w a	d i - s e b e d i s w a
t j h a e l l a	t j h a - e l - l - a
d i h l o m o	d i - h l o m o
a n a n e l w e	a n a n e l - w - e
b a l a m o d i	b a - l a m o d i
n t s h e t s e	n t s h - e t s - e
W o r k e r s	W o r k e r s
i n d a s t e r i n g	i n d a s t e r i n g
m a l w e t s e	m a - l w e t s e
m m o k o	m o - m m o k o
h l o p h i s a	h l o p h - i s - a
d i p h a t l a l a t s o	d i - p h a t l a l a t s o
d i m e l a	d i - m e l a
d i r o y a l t y	d i - r o y a l t y
t s o t e l l a	t s o t - e l - l - a
d u m e l l w e	d u m e l - l - w - e
N g w a n a	m o - N g w a n a
m a k g o t l e n g	m a - k g o t l e n g
f o r e n s i k i	f o r e n s i k i
d i n o m o r o	d i - n o m o r o
h a e l l a n g	h a e l - l - a - n g
t s a m i s o	t s a m i s o
t e k a n y e t s o	n - t e k a n y e t s o
i t e a n g w e	i - t e a - n g - w - e
t h a r o l l o n g	n - t h a r o l l o n g
d i t h a r o l l o	d i - t h a r o l l o
b o i k g a t h a t s o	b o - i k g a t h a t s o
e t s a h a t s a	e t s - a h a - t s - a
m o l a e t s a	m o - l a e t s a
d i t l a n g	d i - t l a n g
t o t o b a t s a n g	t o t o b a - t s - a - n g
e n n g w e	e n n g w e
K g a t i s o	N - K g a t i s o
b o k g o n i n g	b o - k g o n i n g
m a s h a n o	m a - s h a n o
m o f u a	m o - f u a
t j h a n k a n e n g	t j h a n k a n e n g
R e p u b l i c	R e p u b l i c
s e b e d i s a n a	s e b e d - i s - a n - a
s e t e i s h e n e	s e - t e i s h e n e
d i k g w e r e k g w e r e n g	d i - k g w e r e k g w e r e n g
S e t i f i k e i t i	s e - t i f i k e i t i
S e t s w a n a	s e - t s w a n a
k g o n e n g	k g o n - e - n g
l a t e l l a	l a t e l - l - a
t s e b i s i t s w e n g	t s e b - i s - i t s - w - e - n g
b o n a h e t s e n g	b o n - a h - e t s - e - n g
U N D P	U N D P
K h o m i s h e n e n	K h o m i s h e n e n
l a e l a n g	l a - e l - a - n g
m e r u	m e - r u
m o r a o r a o	m o - r a o r a o
n y a l a n y o	n y a l a n y o
t a t a i s w a n g	t a t a - i s - w - a - n g
i p i t s a n g	i - p i t s - a - n g
t s e b a h a l a	t s e b - a h a l - a
e k a	e k a
f u r a l l a	f u r a l l - a
b a t l e t s w e n g	b a t l - e - t s - w - e - n g
l e f a	l e f - a
a r o l e l w a n a	a r o l - e l - w - a n - a
M i l l e n i a m o	M i l l e n i a m o
d i d i k a	d i - d i k a
b e h w a n g	b e h - w - a - n g
d i t h u t o n g	d i - t h u t o n g
k g a t e l o p e l e	n - k g a t e l o p e l e
s e b e t s w a	s e b e t s - w - a
q o b a n e n g	q o b - a n - e - n g
e l a n g	e l - a - n g
d i t e k o l o	d i - t e k o l o
r w e s i t s w e n g	r w - e s - i t s - w - e - n g
M a w a t l e n g	m a - w a t l e n g
h w a	h w a
t s e k o	t s e k o
m e b i l e n g	m e - b i l e n g
n o l o f a t s a	n o l o - f a - t s - a
d i t l a l e h o	d i - t l a l e h o
h o p o t s a	h o p o - t s - a
I s r a e l	I s r a e l
s e b e t s w e	s e b e t s - w - e
l e b o p o	l e - b o p o
d i T e c h n i c a l	d i - T e c h n i c a l
h u t s w e n g	h u - t s - w - e - n g
r w e s i t s e n g	r w - e s - i t s - e - n g
t l e	t l - e
f e p a	f e p - a
l e f e	l e f - e
k e n n g w a n g	k e n - n g - w - a - n g
A U	A U
m o f e r e f e r e	m o - f e r e f e r e
p h e p e t s o	p h e p e t s o
t h u s w e	t h u s - w - e
p a l o	n - p a l o
m e l a t o	m e - l a t o
f a p a f a p a n e	f a p a f a p a n - e
b o i q a p e l o	b o - i q a p e l o
a t h e	a t h e
m o h l a n k a	m o - h l a n k a
t s e p a m i s o	t s e p a m i s o
s e m e l o	s e - m e l o
b a k w a	b a k - w - a
b o i t s e k o n g	b o - i t s e k o n g
n a t e f e l w a	n a t e - f - e l - w - a
S e l e h a e	s e - l e h a e
t e k o n g	n - t e k o n g
h l o m a n g	h l o m - a - n g
k g u t s u f a t s o	n - k g u t s u f a t s o
b a n y a n e	b a n y a n e
e t e l l e t s e	e t - e l - l - e t s - e
S A S O	S A S O
s e t h a t h o n g	s e - t h a t h o n g
m a k g a l a	m a - k g a l a
k a r e t e	k a r e t e
t j h o n a	t j h o n - a
s i s i n y a	s i s i n y - a
E I	E I
k g u t s u f a d i t s w e n g	k g u t s u f a - d - i t s - w - e - n g
N a h a n a	N a h a n - a
a m o h e l e h i l e n g	a m o h e l - e h - i l - e - n g
n t s h a	n t s h - a
k g a s o	n - k g a s o
n a h a n i s i s a	n a h a n - i s - i s - a
D i n i l e s i z w e	D i n i l e s i z w e
n n e	n n e
r e k e	r e k - e
s e p h a	s e - p h a
l a o l l e	l a o l - l - e
b e e l e t s a	b e - e l - e t s - a
w i l i n g	w i l i n g
f e t o l e l a	f e t o l - e l - a
P o t l a k i s i t s w e n g	P o t l a k - i s - i t s - w - e - n g
p h o s o	n - p h o s o
d i k g o t h a l e t s o	d i - k g o t h a l e t s o
d i p r o j e k e	d i - p r o j e k e
t e m o h o	n - t e m o h o
i n t a s t e r i	i n t a s t e r i
p o l o k e l o	n - p o l o k e l o
b o l o k i l w e n g	b o l o k - i l - w - e - n g
p h e p o	n - p h e p o
D E A & T	D E A & T
n t a t e	n t a t e
m o l a w a n a	m o - l a w a n a
k g a o h a	k g a - o h - a
T j h a d i m o	N - T j h a d i m o
t o b i l w e n g	t o b - i l - w - e - n g
s a l a s a l a	s a l a s a l - a
L e p e t j o	l e - p e t j o
t s h o h i l e	t s h o h - i l - e
n t l a f a l e	n t l a - f a l - e
d i t l o k o t s e b e	d i - t l o k o t s e b e
h o k e t s w e n g	h o k - e - t s - w - e - n g
p o t o f o l i o	p o t o f o l i o
E p h r a i m	E p h r a i m
m a r u o	m a - r u o
b o i k g e t h o	b o - i k g e t h o
b u l e l a	b u l - e l - a
T h e o	T h e o
t e f e l l o n g	n - t e f e l l o n g
d i p s y c h o m e t r i c	d i - p s y c h o m e t r i c
b u l e h a	b u l - e h - a
